the notion that tracking is somehow undemocratic is absurd	the notion is absurd
but they disagree about the message these settlements give to the public	but they disagree about the message
but some militant sci tv junk-holders say that 's not enough	but some militant sci tv junk-holders say
they contend that sci tv 's equity now is worthless	they contend
bus schedules were sometimes in disarray stranding commuters such as marilyn sullivan	bus schedules were sometimes in disarray
it 's worse than i thought she said	it 's worse she said
i do n't know where all the buses are	i do n't know
i think a lot of people got scared and stayed home	i think
he succeeds paul j. montle 42 who will remain chairman	he succeeds paul j. montle 42
i think it 's more an issue of style	i think
reebok added that mr. fireman will assume the title of president	reebok added
there should be no great rush for investors to buy this	there should be no great rush
i do n't think the bush administration has done anything he says	i do n't think he says
many companies have set up machinery to assure workers a fair shake	many companies have set up machinery
japanese companies fare best in u.s. when they give americans more say	japanese companies fare best in u.s.
but they think promotions are limited	but they think
some consultants had insisted it would n't work	some consultants had insisted
i can tell you that nobody quit over it	i can tell you
the atlanta-based chemical manufacturer said lower prices hurt margins for most products	the atlanta-based chemical manufacturer said
if one city is down the other can take over	the other can take over
in congress lawmakers already are looking for ways to add relief funds	in congress lawmakers already are looking for ways
digital also said it has dispatched teams of technicians to california	digital also said
the protesters point out that galileo also could crash to earth then	the protesters point out
the earthquake caused many streets to buckle and crack making them impassible	the earthquake caused many streets to buckle and crack
but many predicted that the commercial disruption would be short-lived	but many predicted
you certainly can say it 's going to be extremely severe	you certainly can say
now we realize what our mothers must have gone through she says	now we realize she says
but the man who built it has fallen	but the man has fallen
but u.s. officials have strong doubts that he is a reformer	but u.s. officials have strong doubts
food companies probably wo n't cut their prices much blaming other costs	food companies probably wo n't cut their prices much
never mind that her husband prefers crest	never mind
they 're buying whatever 's cheaper	they 're buying
consider for example what happened to maxwell house coffee	consider for example
in addition power failures prevented its package-sorting facilities from operating causing delays	in addition power failures prevented its package-sorting facilities from operating
the transit system is how people are going to be getting around	the transit system is
there 's no question it will make lbos more expensive he said	there 's no question he said
the interest deduction was the engine that made these things more productive	the interest deduction was the engine
this is indeed what the market decided	this is indeed
but this is not where the rewards of junk financing were found	but this is not
but when the dow jones industrial average rose instead bonds drifted lower	but bonds drifted lower
i think this is a market that required some level of security	i think
treasury bonds ended narrowly mixed in quiet trading	treasury bonds ended in quiet trading
investment-grade corporate bonds ended 1\/4 point lower	investment-grade corporate bonds ended
mortgage securities ended little changed after light dealings	mortgage securities ended after light dealings
traders said today may be an anxious day for the market	traders said
he added b.a.t has no expectation of a material impact on farmers	he added
michael maynard offered the world a faster way to break eggs	michael maynard offered the world a faster way
mr. maynard claims this is a manageable problem	mr. maynard claims
mr. maynard says the ruling pushed his company into bankruptcy court	mr. maynard says
but as the outcry faded by the spring of 1988 they resumed	but they resumed
i do n't want to feel guilty representing my constituents	i do n't want to feel guilty
if that takes money take it away from this discredited federal department	take it away from this discredited federal department
she says it 'd create 600 jobs and bring cleveland tourist revenue	she says
until then the billions hud spends on inner-city housing simply is wasted	until then the billions simply is wasted
no doubt he believes the place can be salvaged	no doubt he believes
kansas power said mr. black 61 chose early retirement	kansas power said
allied-lyons while powerful in whiskey does n't own any major white-spirit brands	allied-lyons does n't own any major white-spirit brands
as that system grows larger computers may be needed	larger computers may be needed
our attitude is that the ranking is like miss america	our attitude is
once you 're miss america you 're always miss america	you 're always miss america
many atlantans thought pittsburgh was an unworthy heir	many atlantans thought
mr. savageau says earthquake or not san francisco makes the list	mr. savageau says
you do n't know which way to punch	you do n't know
but when stocks held steady treasury bonds later retreated	but treasury bonds later retreated
ford has signaled it might acquire a majority interest later	ford has signaled
analysts say usair has great promise	analysts say
she thinks traders should buy the stock if it tumbles to 35	she thinks
however mr. steinhardt says he 's comfortable holding usair as an investment	however mr. steinhardt says
british airways said it has n't received a proposal from jal	british airways said
gas to fuel it would be piped from the north sea	gas would be piped from the north sea
when mr. trump sued bally he sued only on behalf of himself	he sued only on behalf of himself
reflecting that logic insurance-company stocks posted strong gains	insurance-company stocks posted strong gains
that included capital gains that were passed along to customers	that included capital gains
formerly president and treasurer mr. lang remains chief executive officer	mr. lang remains chief executive officer
the company citing market conditions postponed a 200 million debt offer	the company postponed a 200 million debt offer
in june the chicago board of trade said it suspended capcom financial	in june the chicago board of trade said
the company said the move recognizes its strong financial position	the company said
he said the ordinance also will benefit the mentally retarded	he said
some dealers say other traders were n't picking up their phones	some dealers say
it 's very worrying that these markets ca n't cope	it 's very worrying
but it 's just one of those things that happened	but it 's just one of those things
they all said they invested huge amounts of money	they all said
i do n't know how much got through	i do n't know
analysts said the move could presage even harsher action by the banks	analysts said
the company said it expects to release third-quarter results in mid-november	the company said
exxon corp. said it will move its headquarters from manhattan to dallas	exxon corp. said
if this were 1949 mr. boren might even succeed	mr. boren might even succeed
maine republican william cohen said the plan might violate the assassination ban	maine republican william cohen said
i would n't say it 's quite a veto mr. boren demurs	i would n't say mr. boren demurs
the spokesman said unocal has had considerable interest from prospective buyers	the spokesman said
companies that only recently were thriving find themselves scrambling to survive	companies find themselves scrambling to survive
it 's evident we 're entering a more competitive era he says	it 's evident he says
i would n't say we 're out of the business	i would n't say
it also was considering a restructuring to help boost the stock price	it also was considering a restructuring
they note that stocks experienced volatile swings long before futures	they note
much is being done in colombia to fight the drug cartel mafia	much is being done in colombia
if you do n't you ca n't do your job	you ca n't do your job
when will i get that check for a million dollars he jokes	he jokes
so many californians believe they can get by without it	so many californians believe
now she says she 's thinking of contacting her own insurance agent	now she says
her sister cynthia wishes toni had a different job	her sister cynthia wishes
it 's all i think about or talk about	it 's all
that 's just what happened in the october 1987 crash	that 's just
unable to stop his accelerating descent he crashes	he crashes
it 's doubtful though whether circuit breakers do any real good	it 's doubtful though
the fed also has the power to set margin requirements	the fed also has the power
while the theme is compelling the plot and characters are not	the plot and characters are not
we never care about said or the hypocrites he hunts	we never care about said or the hypocrites
but the device obscures more than it illuminates	but the device obscures more
if they finish today the sharpshooter can pump tomorrow	the sharpshooter can pump tomorrow
though modest the change reaches beyond the oil patch too	the change reaches beyond the oil patch too
still there is money to be made	still there is money
first year i came back there was n't any work he says	first year there was n't any work he says
i think it 's on the way back now	i think
the figures confirm that there certainly is n't any drilling boom	the figures confirm
i sense that it 's going to continue to grow	i sense
the exchange had forecast that the contract would begin trading by december	the exchange had forecast
flight attendants lag before jets even land	flight attendants lag
experts say such long hours for attendants pose a safety risk	experts say
the vaccine however causes allergic reactions that can be fatal	the vaccine however causes allergic reactions
it has more drug users than boston has people	it has more drug users
i am aware we have real budgetary problems	i am aware
but city officials say tax revenues are lagging	but city officials say
these campaign problems have echoed difficulties mr. dinkins has run into before	these campaign problems have echoed difficulties
but the guy is so personally decent people tend to forget that	but the guy is so personally decent
we did n't rubber-stamp everything that came to us mr. lynch says	we did n't rubber-stamp everything mr. lynch says
in the end i think david will be judged for being david	in the end i think
but there appear to be few if any suitors	but there appear to be few suitors
of the almost 3,000 athletes surveyed 1,240 took the time to respond	of the almost 3,000 athletes surveyed 1,240 took the time
the rest as they say is history	the rest is history
what could have been better asks mr. engelken	asks mr. engelken
i never thought it would become so momentous bobby remarked	i never thought bobby remarked
accepted theories state that investors require higher returns on riskier investments	accepted theories state
this means the returns can vary a great deal	this means
the markets are complex as is the environment in which they function	the markets are complex
there 's some price at which we 'd stop bidding	there 's some price
he would n't specify what it was	he would n't specify
imports of goods and services soared while exports were flat	imports of goods and services soared
the only question is how deep is it going to be	the only question is
now it 's dawning on them that they can be non-wealthy	now it 's dawning on them
he did n't stop until he got to jackson hole wyo	he did n't stop
he started building the files that helped him gain power	he started building the files
people started wondering if something was wrong with him mr. miranda recalls	people started wondering mr. miranda recalls
if he had been found guilty we could have stopped him	we could have stopped him
but yesterday 's announcement indicates that ford has n't lost interest	but yesterday 's announcement indicates
nasa estimated that on monday about four computer centers were affected	nasa estimated
nasa said the galileo worm had nothing to do with either delay	nasa said
mr. alexander of computerworld said hackers have gone after span before	mr. alexander of computerworld said
health benefits remain a central lobbying effort even as section 89 fades	health benefits remain a central lobbying effort
you hate to do it because he 's your father	you hate to do it
a beatrice spokesman did n't return calls seeking comment	a beatrice spokesman did n't return calls
then it rebounded to finish down only 18.65 points	then it rebounded
it added another 5 % monday before stocks rallied	it added another 5 % monday
all you get is risk	all is risk
then they said by the way two of the doors are locked	then they said
some experts say markets are n't as volatile as widely assumed	some experts say
some people think the search for liquidity is fruitless	some people think
he succeeds everett meyers who resigned in may	he succeeds everett meyers
when stocks stabilized that was a disappointment	that was a disappointment
she said a more aggressive move was n't needed	she said
traders said hedging related to the tva pricing also pressured treasury bonds	traders said
markets usually get noticed because they soar or plunge	markets usually get noticed
it 's an experience they do n't want to repeat	it 's an experience
another analyst noted that cuba has been deferring shipments in recent years	another analyst noted
corn futures prices rose slightly while wheat prices settled mixed	corn futures prices rose slightly
this says ms. peterson is what it 's all about	this says ms. peterson is
i think we 're making progress	i think
we do n't want to bring back something the members will reject	we do n't want to bring back something
of the 4,345 stocks that changed hands 1,174 declined and 1,040 advanced	of the 4,345 stocks 1,174 declined and 1,040 advanced
those who bought that illusion are now bewildered	those are now bewildered
the u.s. said it would fully support the resistance and did n't	the u.s. said and did n't
the company said it expects consumers will adjust to higher-priced soft drinks	the company said
trouble was nobody thought they looked right	trouble was
did mr. loeb seek personal gain and if so how	did mr. loeb seek personal gain and how
had the case gone to trial the same issues would have surfaced	the same issues would have surfaced
was there a fiduciary breach in order to obtain personal gain	was there a fiduciary breach
arguably both were on notice that their behavior was at least risky	arguably both were on notice
he succeeds john a. boudreau who resigned for personal reasons	he succeeds john a. boudreau
conservatives have an important decision to make this fall	conservatives have an important decision
both said the new plan would n't work	both said
however that does n't mean they can benefit from the vaccine	however that does n't mean
we 've demonstrated that you can	we 've demonstrated
he said certain volunteers developed kinds of antibodies associated with early aids	he said
in april 1987 evidence surfaced that commissions were paid	in april 1987 evidence surfaced
measured the same way the decline for black males was 14.2 %	the decline for black males was 14.2 %
the dow jones transportation average fell 49.96 to close at 1254.27	the dow jones transportation average fell 49.96
this is no time to be playing in the street	this is no time
and he added that manufactured goods exports are still rising	and he added
but stocks later recovered erasing most of their early declines	but stocks later recovered
officials there declined to comment as did helmsley management	officials there declined to comment
schering-plough said sales gained 2.7 % to 743.7 million from 724.4 million	schering-plough said
the talks came as lebanese negotiations on political changes appeared deadlocked	the talks came
thus we have a condition that is easily described as undemocratic	thus we have a condition
on average something that cost 100 30 years ago now costs 425	on average something now costs 425
but it has only the fed to pursue price-level stability	but it has only the fed
that 's something they can do very well	that 's something
not everybody agrees that it 's time to trim	not everybody agrees
an earnings disappointment may reflect a situation that 's short-term	an earnings disappointment may reflect a situation
but mr. clough says the risk is that earnings disappointments will continue	but mr. clough says the risk is
you eliminate companies with substantial prospects that are moving up in price	you eliminate companies with substantial prospects
time to sell says mr. schlesinger	time says mr. schlesinger
the mayor said the quayle visit was a publicity stunt	the mayor said
sir richard succeeds john plastow who resigned in july	sir richard succeeds john plastow
mca said revenue rose 14 % to 918.4 million from 806.7 million	mca said
pemex which produces 40 % of government revenue desperately needs new investment	pemex desperately needs new investment
little money has been returned to upgrade pemex 's aging facilities	little money has been returned
it 's no secret that block dominates the mass-market tax-preparation business	it 's no secret
i think a lot of their businesses are just so-so	i think
to be sure the stock still has a lot of fans	the stock still has a lot of fans
i do n't know what the risk is of holding the stock	i do n't know
none dare say to sell it	none dare say
mr. bloch concedes that a recent diversification attempt fell through	mr. bloch concedes
and he says block 's other businesses are growing although less consistently	and he says
the company mr. renzas said has n't yet determined what to do	the company mr. renzas said has n't yet determined
the report suggested that current review programs are too narrow	the report suggested
but there is no solid evidence that the khmer rouge have changed	but there is no solid evidence
the dollar finished mixed while gold declined	the dollar finished
but he continues they 're forgetting we 're all texans	but he continues they 're forgetting
and ad agencies insist that they do	and ad agencies insist
it says it may pull its clients ' ads from those magazines	it says
as the west german currency rose so did merkur prices	so did merkur prices
ford said then it would keep the scorpio	ford said then
it depends on when you look	it depends on
it suggests that households accumulate wealth across a broad spectrum of assets	it suggests
the charts show how househld assets have been distributed over time	the charts show
healthcare operates many of the health-care properties that healthvest owns	healthcare operates many of the health-care properties
the company also said its 1990 annual meeting has not been scheduled	the company also said
and security authority robert l. duston favors disciplining all employees who cheat	and security authority robert l. duston favors disciplining all employees
that 's usually how long it takes for the temblors to pass	that 's usually
i was in the berkeley main library when it hit	i was in the berkeley main library
areas that are made of fill liquefy	areas liquefy
it flopped all around real dramatic	it flopped all around
i actually thought that i might die	i actually thought
it 's hard to believe this really is happening	it 's hard to believe
i was in stinson beach when the quake rolled through town	i was in stinson beach
needless to say it was an interesting first session	it was an interesting first session
we are all fine here although mame was extremely freaked	we are all fine here
it 's amazing how one second can so completely change your life	it 's amazing
i wonder when we 'll be able to relax	i wonder
if people are n't buying you have to close plants he said	you have to close plants he said
the financial times 30-share index settled 27.8 points higher at 1758.5	the financial times 30-share index settled at 1758.5
declining issues outnumbered advancers 505-455 with 172 unchanged	declining issues outnumbered advancers 505-455
south african gold stocks ended marginally firmer	south african gold stocks ended
ex-im bank officials said this review process currently is under way	ex-im bank officials said
wacoal said it intends to produce the cars through a car manufacturer	wacoal said
winners outnumbered losers 645-293 with 186 issues unchanged	winners outnumbered losers 645-293
b.a.t said it purchased 2.5 million shares at 785	b.a.t said
analysts predict the sales impact will linger	analysts predict
he added though that a lot of this is intentions	he added though
we 'll have to wait and see how the plan develops	we 'll have to wait and see
but much will depend on how quickly ibm can move	but much will depend on
but he said a system such as ibm 's should help significantly	but he said
i suggest your reporter see charleston next spring in its full glory	i suggest
the 650-or-so local whites who are n't orange workers are more troubled	the 650-or-so local whites are more troubled
bond market analysts say the institutional selling was triggered by several factors	bond market analysts say
such bonds she says are those that are nearing their call date	such bonds she says are those
but he thinks investors may be overreacting to the market 's problems	but he thinks
we 've got a lot to do he acknowledged	we 've got a lot he acknowledged
there is no mystery why the delta originated singin the blues	there is no mystery
compare the bush request to what the senators gave themselves	compare the bush request to
mr. whittle friday said several more advertisers have been added	mr. whittle friday said
it said net income will rise 25 % to 69 billion yen	it said
and even without deals mr. connolly figures the market would remain healthy	and even without deals mr. connolly figures
it depends on what happens	it depends on
but mr. lagnado predicted the regional trends would continue through christmas	but mr. lagnado predicted
the cftc has 90 days to respond to such applications	the cftc has 90 days
so far there is little to show for such efforts	so far there is little
that 's not what our fathers had in mind	that 's not
he said no discussions currently are taking place between the two companies	he said
he noted that higher gasoline prices will help buoy the october totals	he noted
because the law made compliance voluntary it inspired little more than jokes	it inspired little more than jokes
the pentagon has led the charge particularly as military alliances spread world-wide	the pentagon has led the charge
note how the baseline program assumes a sharp increase in future appropriations	note
someone must monitor where the funds are deployed says mr. dave	someone must monitor says mr. dave
the government insists that such a possibility is low	the government insists
our president said acquisition is an effective method	our president said
but he said dentsu has n't looked seriously at saatchi	but he said
dr. lourie says the justice department interviewed him last july	dr. lourie says
i 'm happy that he feels positively about our company he said	i 'm happy he said
finnair and sas said they plan to swap stakes in each other	finnair and sas said
the company said it was delaying construction because of current market conditions	the company said
he said construction would n't resume until market conditions warrant it	he said
kellogg indicated that it has room to grow without adding facilities	kellogg indicated
subcontractors said they were told that equipment orders would be delayed	subcontractors said
as expected kellogg reported lower third-quarter earnings	kellogg reported lower third-quarter earnings
the company would n't elaborate citing competitive reasons	the company would n't elaborate
the company said the move was necessary to meet capital requirements	the company said
octel said the purchase was expected	octel said
we have no further developments to report he said	we have no further developments he said
in these circumstances i think they 'd win	in these circumstances i think
oils and fats also did well posting a 5.3 % sales increase	oils and fats also did well
imelda marcos asks for dismissal says she was kidnapped	imelda marcos asks for dismissal says
cbs news sends scripts to agents who pass them along to clients	cbs news sends scripts to agents
mr. sukle says he would n't dream of participating himself	mr. sukle says
mrs. hoffman says that dramatization makes the truth flexible	mrs. hoffman says
istat said the statistics are provisional and are n't seasonally adjusted	istat said
while some automotive programs have been delayed they have n't been canceled	they have n't been canceled
paper companies concede that business has been off recently	paper companies concede
the companies in question believe the analysts are too pessimistic	the companies in question believe
the analysts say their gloomy forecasts have a flip side	the analysts say
but some analysts wonder how strong the recovery will be	but some analysts wonder
gm confirmed it received u.s. antitrust clearance to boost its holding	gm confirmed
bond mutual funds offer diversification and are easy to buy and sell	bond mutual funds offer diversification and are easy
buyers can look forward to double-digit annual returns if they are right	buyers can look forward to double-digit annual returns
the price movements get bigger as the maturity of the securities lengthens	the price movements get bigger
now the firm says it 's at a turning point	now the firm says
i 've done what i came to do at kidder he says	i 've done at kidder he says
mr. volk 55 years old succeeds duncan dwight who retired in september	mr. volk 55 years old succeeds duncan dwight
an earthquake struck northern california killing more than 50 people	an earthquake struck northern california
macmillan said berlitz intends to pay quarterly dividends on the stock	macmillan said
it is n't that major steelmakers have blithely ignored high technology	it is n't
battelle 's mr. mccall thinks steelmakers should concentrate more on construction	battelle 's mr. mccall thinks
the comptroller 's office says it is monitoring the situation	the comptroller 's office says
he says he stole them recalls mr. guterman	he says recalls mr. guterman
mr. paul says it was n't that high	mr. paul says
the state gave centrust 30 days to sell the rubens	the state gave centrust 30 days
i 'm forever dumbfounded by what i see making these high prices	i 'm forever dumbfounded by
rather it just shows things have changed	rather it just shows
but he implores that the splendor be played down	but he implores
do n't say it 's a gold ceiling	do n't say
just say the offices are tastefully appointed he says	just say he says
the court left open whether ferc could reimpose a new deadline later	the court left open
this employer embodies all that i find noble and admirable	this employer embodies all
i ca n't even say i made my own mistakes	i ca n't even say
really one has to ask oneself what dignity is there in that	really one has to ask oneself
the disk drives will doubtless sell well when they finally become available	the disk drives will doubtless sell well
i 'm sure he still wants amr	i 'm sure
you 'll start to see shows where viewers program the program	you 'll start to see shows
as previously reported helionetics emerged from chapter 11 bankruptcy-law protection in february	helionetics emerged from chapter 11 bankruptcy-law protection in february
mr. friend says he agreed to strike mr. alexander above the belt	mr. friend says
mr. friend says his side is dead serious	mr. friend says
the official said he also would be comfortable with that new range	the official said
so what 's the best way to buy stocks	so what 's the best way
but that 's just the time when you should be buying them	but that 's just the time
but those who said this ca n't be happening were right	but those were right
it 's been kind of annoying to say the least she said	it 's been kind of annoying she said
but it was the quotron problems that had lingering effects	but it was the quotron problems
integrated did n't identify the party or say why the talks failed	integrated did n't identify the party or say
the cement producer said the payment was made from excess cash flow	the cement producer said
our view is that we may see a profit decline	our view is
some think investors should sell into rallies	some think
what we want to do is take a more aggressive stance	is take a more aggressive stance
but ms. mccraw says the magazine is fighting back	but ms. mccraw says
whether she can meet that ambitious goal is still far from certain	is still far from certain
other companies figure they ca n't avoid the market	other companies figure
yesterday when similar securities rebounded it bumped the valuation up again	yesterday it bumped the valuation up again
william o'donnell president says he still thinks the ipo will succeed	william o'donnell president says
mr. zafris thinks rates are heading down helping small companies	mr. zafris thinks
the record price for associate membership is 275,000 set aug. 30 1988	the record price for associate membership is 275,000
his success is easy to understand	his success is easy
but others said pico should proceed	but others said
we must find any way to get business	we must find any way
now i feel maybe there 's a little bit of euphoria	now i feel
i 'm certainly not comfortable saying we 've seen the bottom	i 'm certainly not comfortable saying
if they do good credit analysis they will avoid the hand grenades	they will avoid the hand grenades
i think the market is in good shape	i think
and even though employees paid the bill taxpayers grumbled	and taxpayers grumbled
massage also has an image problem to contend with	massage also has an image problem
occasionally all that 's needed is a little coaxing	occasionally all is a little coaxing
she notes that she also stresses professionalism during her weekly visits	she notes
the chair is a way to package massage	the chair is a way
institutions that usually buy retail paper have to be more concerned	institutions have to be more concerned
if so the damages could be tripled	the damages could be tripled
mr. allday would succeed martha hesse who is resigning	mr. allday would succeed martha hesse
now his ghost wo n't let up till it 's done	now his ghost wo n't let up
i saw what he did to them firsthand	i saw firsthand
gives me the willies just thinking about it	gives me the willies
sperry merged with burroughs corp. to become unisys corp. in late 1986	sperry merged with burroughs corp. in late 1986
the company says those holdings constitute the third-biggest real-estate portfolio in belgium	the company says
cri which sponsors champs is a world-wide real estate investment firm	cri is a world-wide real estate investment firm
all estimates exclude highway repair which could exceed 1 billion	all estimates exclude highway repair
city building codes require construction that can resist temblors	city building codes require construction
comair said it paid cash but declined to disclose the price	comair said but declined to disclose the price
many arizona real-estate experts think the worst may be yet to come	many arizona real-estate experts think
some in arizona think that may be optimistic	some in arizona think
many law school grads find classes never end	many law school grads find
let me immediately put limits to whatever nostalgic notions that may intimate	let me immediately put limits to
a policeman shakes his head in amazement as he steers them away	a policeman shakes his head in amazement
i do n't know if this would have happened somewhere else	i do n't know
it 's understood several compromises already have been worked into the plan	it 's understood
though tiny that 's a reduction in its share	that 's a reduction in its share
the business closed when the owner was murdered by robbers	the business closed
the second time he identified two robbers who were arrested and charged	the second time he identified two robbers
industrial neighborhoods fare even worse with burglary rates twice the citywide average	industrial neighborhoods fare even worse
one is that there are not enough police to satisfy small businesses	one is
while no guarantee an increased police presence might even deter further attacks	an increased police presence might even deter further attacks
mr. lesko figured he would be flooded with entries by now	mr. lesko figured
but he says he would prefer to get nominations from rank-and-file folks	but he says
maybe people do n't believe i want to give this money away	maybe people do n't believe
democrats hoped that mr. dinkins could become a highly visible national leader	democrats hoped
but our polls show voters do n't like the attack stuff	but our polls show
paper work on how it was spent is incomplete	paper work on is incomplete
asked about that the other day he replied anti-semitic	he replied anti-semitic
he says his son has n't paid for the shares	he says
he waits to talk about it until after he gets caught	he waits to talk about it until
it said the reduced dividend reflects the low price for precious metals	it said
the suit which seeks class-action status was filed in delaware chancery court	the suit was filed in delaware chancery court
if the risks and rewards are reasonable developers will respond	developers will respond
it is a certainty that mr. barre 's days are numbered	it is a certainty
new entitlements tend to grow creating a rationale for new taxes	new entitlements tend to grow
other analysts say that estimate is low	other analysts say
judges will write the real bill as suits roll through the courts	judges will write the real bill
that would give the pentagon flexibility that no other federal agency has	that would give the pentagon flexibility
however more money managers are reassured that profit is regaining importance	however more money managers are reassured
ibm says it considers its shares a good investment	ibm says
but there were fewer price swings than expected	but there were fewer price swings
the company will notify holders of the notes to be redeemed	the company will notify holders of the notes
we think alliances are very important mr. eddington says	we think mr. eddington says
i 'm not sure cross-ownership would necessarily make things smoother	i 'm not sure
but critics fret that post-1997 officials ultimately will be responsible to beijing	but critics fret
we were reassured they would stand behind the company	we were reassured
if we did n't increase prices we 'd be in the red	we 'd be in the red
analysts believe he may ultimately dispose of some of the non-advertising businesses	analysts believe
look how much air is moving around he says	look he says
what really stirs his muse though is aerobic architecture	though is aerobic architecture
but she says i guess i did n't really notice the trees	but she says i guess
if any nation can use environmentally benign architecture it is poland	it is poland
we continue to develop products faster than anyone else can	we continue to develop products faster
foreign traders say the company is strapped for cash	foreign traders say
funds that invest internationally were the top-performing stock and fixed-income funds	funds were the top-performing stock and fixed-income funds
we still think there 's a lot of unsettlement in this market	we still think
but some wall street executives argue that such fears are unwarranted	but some wall street executives argue
but he says cane & associates does n't receive referral fees	but he says
lawyers for the garcias said they plan to appeal	lawyers for the garcias said
we just have n't learned what it takes to compete	we just have n't learned
she said wheeler group was profitable but would n't give figures	she said but would n't give figures
analysts said the company 's troubles mirror those of the industry	analysts said
they got a transaction that 's good for both companies	they got a transaction
both are young one twenty odd the other thirty odd	both are young
what 's so discouraging is	is
among the biggest winners were brokerage-house stocks responding to heavy trading volume	among the biggest winners were brokerage-house stocks
the government said consumer prices rose only 0.2 % last month	the government said
congress would then need the usual two-thirds majority to override any veto	congress would then need the usual two-thirds majority
a spokeswoman for paramount said the company does n't comment on speculation	a spokeswoman for paramount said
a chris-craft station manager said there have been no formal talks	a chris-craft station manager said
while this theory is exceedingly simple it appears to explain several things	it appears to explain several things
strategies vary for westridge capital which has 300 million under management	strategies vary for westridge capital
there are many other strategies to bolster the returns of index funds	there are many other strategies
say a big investor is interested in growth stocks	say
if i survived i would have achieved every journalist 's highest wish	i would have achieved every journalist 's highest wish
the real tragedies occurred elsewhere as we soon found out	the real tragedies occurred elsewhere
the tape was on tv before the night was out	the tape was on tv
bond prices posted strong gains as investors went on a bargain hunt	bond prices posted strong gains
prudential-bache said the york issue was delayed because of market conditions	prudential-bache said
that raised hopes that interest rates will continue to move lower	that raised hopes
travel sales rose 11 % led by gains in the u.s.	travel sales rose 11 %
underwriters insist these issues are constructed to withstand extremely tough economic conditions	underwriters insist
then the computers give us more information than we can ever read	then the computers give us more information
i 'm pretty confident i 'm catching everything he says	i 'm pretty confident he says
but some investors and consultants who have tried it are enthusiastic	but some investors and consultants are enthusiastic
of the 4,346 issues that changed hands 1,435 rose and 629 fell	of the 4,346 issues 1,435 rose and 629 fell
and despite their share of duds they make movies that make money	and despite their share of duds they make movies
i wish they were around 24 hours a day	i wish
he also had to fight harder for credibility than his partner did	he also had to fight harder for credibility
i think peter even made some deals with the gorillas	i think
some companies are confident that they 're prepared	some companies are confident
we feel we are doing everything we can an occidental spokesman says	we feel an occidental spokesman says
still vista officials realize they 're relatively fortunate	still vista officials realize
with a hurricane you know it 's coming	with a hurricane you know
but lawmakers of both parties agree that the streamlining was temporary	but lawmakers of both parties agree
the main obstacle is finding a way to pay for them	the main obstacle is finding a way
here is how three vietnamese are coping with change	here is
nguyen van chan is living proof that old ways die hard	nguyen van chan is living proof
that was the first time they lost and i won he says	that was the first time he says
warned he was to be jailed again he fled to the countryside	he fled to the countryside
they did n't return the rubber stocks that represent his capital	they did n't return the rubber stocks
his dismissal triggered a furor among intellectuals that continues today	his dismissal triggered a furor among intellectuals
for the leadership that was too painful to bear	for the leadership that was too painful
developments like this are hard to predict	developments like this are hard
they always seem to come a bit later than you expect	they always seem to come a bit later
that 's well above what bonds or bank certificates have paid	that 's well above
people my age thought it was n't going to be an issue	people my age thought
it is a distinction that satisfies neither side in the debate	it is a distinction
i do n't think we do now he says	i do n't think he says
if you want more opinions ask my wife	ask my wife
if the whole story were told it would read something like this	it would read something like this
he said he would convene hearings within two weeks	he said
retail sales are plummeting while consumer prices still are rising	retail sales are plummeting
but yesterday the company said this year 's profit will be lower	but yesterday the company said
it said 10 million would go to the university of toronto	it said
that sometimes signals that they are laying plans to export corn	that sometimes signals
maitre'd claims in suit that restaurant fired her because she was pregnant	maitre'd claims in suit
mr. aloe said the odeon has no policy against hiring pregnant people	mr. aloe said
he acknowledged however that washington 's drug-related murder rate is intolerably high	he acknowledged however
but darman suggests such tensions will dissipate quickly	but darman suggests
if i can show signs of maturity almost anybody can he jokes	almost anybody can he jokes
amoco is the first major oil company to report third-quarter results	amoco is the first major oil company
was the man who once was pro-choice but later pro-life converting again	was the man converting again
pro-life advocates say the white house never wavered over the veto	pro-life advocates say
still some analysts insisted that the worst of the inflation is behind	still some analysts insisted
mr. yardeni predicted that world business competition will continue to restrain prices	mr. yardeni predicted
and liquidity is what markets need to damp quakes and aftershocks	and liquidity is
when they halt trading all market liquidity is gone	all market liquidity is gone
what market makers provide is immediacy a very valuable service	is immediacy a very valuable service
they have maintained that banks remain interested in financing the transaction	they have maintained
he predicted the debt ratio will improve further in coming quarters	he predicted
much of what we set out to do is completed	much of is completed
it 's a process that never really ends	it 's a process
some of the coal the plants buy will come from westmoreland mines	some of the coal will come from westmoreland mines
the soviets ' eavesdropping paid off however because they got the contract	the soviets ' eavesdropping paid off however
a women said she saw the park 's light standards sway	a women said
a man said he saw the upper rim undulate	a man said
no longer innocent they qualified as fools	they qualified as fools
you 'll never know 'til you try says a black skier	you 'll never know says a black skier
but some think that 's being overly optimistic	but some think
he believes those defenses might well apply to the bay bridge collapse	he believes
they will do it every chance they get said one program-trading executive	they will do it every chance said one program-trading executive
even if that scenario occurs westinghouse figures it is prepared	westinghouse figures
both companies are conservative marketers that rely on extensive market research	both companies are conservative marketers
the company says sales have soared	the company says
unilever wo n't comment schering however denies the brand is for sale	unilever wo n't comment schering however denies
that sale however could still fall through if financing problems develop	that sale however could still fall through
analysts however were surprised because the tender offer appeared unsolicited	analysts however were surprised
but industry observers still questioned whether georgia pacific will ultimately prevail	but industry observers still questioned
but analysts say sansui is a special case	but analysts say
the result is that the unthinkable and illogical are happening	the result is
the people who tape the most buy the most	the people buy the most
we 're standing in gasoline so do n't smoke	we 're standing in gasoline
transcanada transports all gas that moves eastward from alberta	transcanada transports all gas
wives may not benefit when men do chores	wives may not benefit
it just means that hong kong would become a less exciting place	it just means
think i 'll buy one of those i survived t-shirts after all	think
the joke here is that the giants lost by de fault	the joke here is
the ball he hit was n't a strike	the ball was n't a strike
if it had been he mighta hit it out	he mighta hit it out
it 's easier to get worse than better in this game	it 's easier to get worse in this game
those chains include bloomingdale 's which campeau recently said it will sell	those chains include bloomingdale 's
the plant has a hairy stem that produces flowers and diminutive seeds	the plant has a hairy stem
in sidhpur it is almost time to sow this year 's crop	in sidhpur it is almost time
what 's happening here is n't justified by the fundamentals	is n't justified by the fundamentals
the companies said the acquisition is subject to a definitive agreement	the companies said
they said they expect the transaction to be completed by dec. 15	they said
analysts said they expect mccaw to escalate the bidding again	analysts said
but i do n't think we 're at that point yet	but i do n't think
we think this is a superior deal to mccaw 's	we think
how many shares will be around in 1995 he asked	he asked
switzerland 's most famous raider says he is n't one	switzerland 's most famous raider says
werner k. rey believes fortunes are made by being friendly	werner k. rey believes
mr. rey says the move is yet another example of his conservatism	mr. rey says
he explains that companies with real estate give security	he explains
he says he wants to influence but not manage companies	he says
we suspected there was downtime built into our process	we suspected
the team eliminated the crisis mentality that proposal deadlines can generate	the team eliminated the crisis mentality
but this devastated the u.s. manufacturing sector laying the seeds of protectionism	but this devastated the u.s. manufacturing sector
inflation is easier to spark and harder to control	inflation is easier and harder
the globalists tend to think mr. lawson ran onto technical reefs	the globalists tend to think
but it was the underlying situation that became intolerable	but it was the underlying situation
but it was frank lloyd wright who said is this not anti-christ	but it was frank lloyd wright
some lawmakers may seek legislation to limit overly restrictive insurance policies	some lawmakers may seek legislation
nashua announced the reiss request after the market closed	nashua announced the reiss request
that may be the last thing she needs	that may be the last thing
indeed fujitsu officials admitted they may have been a little overzealous	indeed fujitsu officials admitted
mr. straszheim expects he will take some heat and he 's right	mr. straszheim expects and he 's right
mr. bostian said in august that his macroeconomic index signaled recession	mr. bostian said in august
however risky the business it 's brisk these days	it 's brisk these days
he adds i think it was a fairly decent call	he adds i think
that 's where the two scripts would diverge	that 's
if he calls you up just tell him everything is fine	just tell him
the less they know the easier it is for us	the easier it is for us
a tvs spokesman said he did n't know mr. price 's plans	a tvs spokesman said
a supremely cautious man the fed chairman is forever blinking yellow	the fed chairman is forever blinking yellow
inflation may be stable at the moment running at about 4.5 %	inflation may be stable at the moment
i think you have to give greenspan a good rating	i think
if that happens chairman greenspan could well become an open target	chairman greenspan could well become an open target
already congress is toying with legislation to curb the fed 's independence	already congress is toying with legislation
if the economy turns down such proposals could gain strong momentum	such proposals could gain strong momentum
i am convinced that ufos exist because i have seen one	i am convinced
what 's more the seven mail personnel aboard were missing	the seven mail personnel aboard were missing
first and foremost mr. phillips said he hopes to improve client service	first and foremost mr. phillips said
he is n't as well-known to clients as is mr. roman	he is n't as well-known to clients
car sales slackened in september after the 1990 models were introduced	car sales slackened in september
that was n't always the way the reagan administration handled such matters	that was n't always the way
sen. cohen said the relationship has reverted to its pre-reagan character	sen. cohen said
there still are some details to be nailed down	there still are some details
mr. dorgen has changed tactics dropping the seat-for-the-secretary idea	mr. dorgen has changed tactics
plant lovers who studied the maquette were alarmed	plant lovers were alarmed
mr. quennell has said he plans to go with the grid regardless	mr. quennell has said
mr. trivelpiece 58 years old succeeds william bolger who died in august	mr. trivelpiece 58 years old succeeds william bolger
it is n't yet clear whether the 200-ruble limit will be lifted	it is n't yet clear
and while the job is half done brooks is still bitter	and brooks is still bitter
i feel better than i ever have in my life he says	i feel better he says
i 'm enjoying my life and who i am today	i 'm enjoying my life and
you could say she survived but it was n't easy on her	you could say but it was n't easy on her
if sex is involved all bets are off	all bets are off
mr. bauman a conservative says he was deserted by the right wing	mr. bauman a conservative says
he reassured me that the hurricane would end mr. deaver recalls	he reassured me mr. deaver recalls
nasa said general dynamics will launch crres using an atlas 1 rocket	nasa said
it said the maximum cost of the plan would be 9.7 million	it said
trouble is junk bond prices have been weak for months	trouble is
high cash positions help buffer a fund when the market falls	high cash positions help buffer a fund
mr. schwarz says the competition broadens the base of opportunity for us	mr. schwarz says
but nevada state labor economists think a shortage is probable	but nevada state labor economists think
many people here expect a room-rate war as the new projects open	many people here expect a room-rate war
older properties that still have a 1950s image are also vulnerable	older properties are also vulnerable
there 's seven million square feet of space that 's doing great	there 's seven million square feet of space
the spokeswoman said the exchange would resume trading of delmed stock today	the spokeswoman said
it added that no discussions about such a sale are under way	it added
when the computer says switch renaissance switches	renaissance switches
ms. kolber said the committee had received other bids	ms. kolber said
those investors think sci tv needs new equity to survive	those investors think
those of course were the responses of people with something to hide	those of course were the responses of people with something
alamco inc. said its board has approved a 1-for-10 reverse stock split	alamco inc. said
it 's the overload problem and the weight problem we have	it 's the overload problem and the weight problem
the junk-mail titans ever optimistic are looking for ways around the problem	the junk-mail titans are looking for ways around the problem
no wonder the competition 's green with envy the announcer says	no wonder the announcer says
he was performing for pay and why should anyone expect anything more	he was performing for pay and
there is evidence to support that view	there is evidence
if there is no law against it do it	do it
if the law leaves loopholes use them	use them
mr. carter is a political commentator who heads a television production firm	mr. carter is a political commentator
it is what lawyers call fact intensive	it is
it was the plunge that did n't happen he says	it was the plunge he says
we believe that the vast majority of imported material is safe	we believe
some jewelers have geiger counters to measure topaz radiation	some jewelers have geiger counters
capital travels to europe as 1992 unification nears	capital travels to europe
continentals believe that the strongest growth area will be southern europe	continentals believe
am stereo remains largely undeveloped because it lacks a uniform delivery system	am stereo remains largely undeveloped
it is currently waiving management fees which contributes to the higher yield	it is currently waiving management fees
we now know that the words were not always his own	we now know
computer sciences said its work will improve mail-processing efficiency	computer sciences said
mr. milgrim succeeds david berman who resigned last month	mr. milgrim succeeds david berman
mr. marous said westinghouse would own 70 % of the facility	mr. marous said
other democrats who favor a capital-gains cut are even more pessimistic	other democrats are even more pessimistic
it 's unlikely extracting the gas will cause subsidence says a spokeswoman	it 's unlikely says a spokeswoman
the company said a new chief operating officer wo n't be appointed	the company said
mr. deng added says mr. lee that we really made mistakes	mr. deng added says mr. lee
bush and deng are hoping that cooler heads prevail	bush and deng are hoping
he predicted that pwa would have little difficulty attracting prospective buyers	he predicted
even excluding the charge however net fell 5 %	however net fell 5 %
call it anecdotal if you will	call it anecdotal
but that does n't mean i 'm not going to get angry	but that does n't mean
it comes real gentle before it pulls	it comes real gentle
do n't forget trout have very soft mouths	do n't forget
pickin one or two says the guide chuckling	pickin one or two says the guide
you can tell they 've got nothin	you can tell
no one has alleged that the donations were by themselves illegal	no one has alleged
its stake is even smaller if life insurance is included	its stake is even smaller
they are n't controlling their destiny like they used to	they are n't controlling their destiny
murray lawrence lloyd 's chairman agrees the exchange faces big challenges	murray lawrence lloyd 's chairman agrees
sandwiched between desks underwriters sit on benches surrounded by stacks of policies	underwriters sit on benches surrounded by stacks of policies
it could take six months for a claim to be paid	it could take six months
some maintain underwriters also have been inept	some maintain
the filing said the group continues to hold 3,481,887 remaining shares	the filing said
if they tried to sell they 'd be chasing their own tail	they 'd be chasing their own tail
even if there is no restructuring manville seems to be attractive long-term	manville seems to be attractive long-term
mr. bullock says 45 % of revenues are tied to construction	mr. bullock says
litigation if not settled out of court could drag on for years	litigation could drag on for years
mr. dozen succeeds sadakane doi who will become vice chairman	mr. dozen succeeds sadakane doi
if mr. dozen has a weakness it may be his golf game	it may be his golf game
the government sought a criminal penalty because no cleanup is possible here	the government sought a criminal penalty
a company official said the explosions began when a seal blew out	a company official said
the selling that started on friday continued yesterday	the selling continued yesterday
this activity produced small rallies which in turn attracted new short selling	this activity produced small rallies
he taught me how to play like a gypsy jokes the musician	he taught me jokes the musician
i did n't learn to count until i got to juilliard	i did n't learn to count
i think i had to prove myself to her says mr. mcduffie	i think says mr. mcduffie
she thought i was n't getting my practicing done	she thought
that 's the only note that 's truly in tune	that 's the only note
the only time the violin has it is right at the end	the only time is right at the end
i do n't know why barber never told anybody else	i do n't know
his performance was so effusive and driven that the phrases rarely breathed	his performance was so effusive and driven
it 's hard to think someone is raping your garden he says	it 's hard to think he says
whatever the difficulties mr. gorbachev remains committed to increasing foreign trade	mr. gorbachev remains committed to increasing foreign trade
unless the questions are answered i will keep on going	i will keep on going
in a way that 's what this is mr. gonzalez concedes	in a way that 's mr. gonzalez concedes
shevardnadze admitted that moscow violated the 1972 abm treaty	shevardnadze admitted
the official stressed that the plo has n't rejected the five-point formula	the official stressed
some auto executives believe the benefits of more choice outweigh the drawbacks	some auto executives believe
stocks also rose in london while the frankfurt market was mixed	stocks also rose in london
on the hat side i was n't getting what i wanted	on the hat side i was n't getting
if you are born to give parties you give parties	you give parties
she was interested only if she could guide it editorially as well	she was interested
the company said its revenue will exceed 750 million this year	the company said
mrs. coleman 73 who declined to be interviewed is the maidenform strategist	mrs. coleman 73 is the maidenform strategist
maidenform says it is very profitable but declines to provide specifics	maidenform says but declines to provide specifics
you never know where she 'll turn up	you never know
top officers insist maidenform 's greatest strength is its family ownership	top officers insist
u.s. memories needs a catalyst he said to inspire others to join	u.s. memories needs a catalyst he said
personal-computer maker ast research inc. said it is still studying the situation	personal-computer maker ast research inc. said
the night the germans occupied all of france baker performed in casablanca	the night baker performed in casablanca
in case you have forgotten his name was rudolph dirks	his name was rudolph dirks
it 's the one-upsmanship of name-dropping that counts	it 's the one-upsmanship of name-dropping
mr. thal says that elizabeth taylor a client hates being called liz	mr. thal says
that 's because they only drop mere names says mr. churchill	that 's says mr. churchill
now they know who you mean and you know who you mean	now they know and you know
now that 's name-dropping if you know what i mean	now that 's name-dropping
he said the transaction was made for investment purposes	he said
they were either too small or uneconomic to maintain the company said	they were either too small or uneconomic the company said
once they are in the building they stay	they stay
harsco declined to say what country placed the order	harsco declined to say
integrated made its announcement after the market closed	integrated made its announcement
at&t already has a factory in matamoros mexico to make electrical devices	at&t already has a factory in matamoros mexico
municipals ended mixed while mortgage-backed and investment-grade corporate bonds rose	municipals ended mixed
and the sets are wider resembling the dimensions of a movie screen	and the sets are wider
for the future he said he would run for governor of florida	for the future he said
imperial said it had n't been served with this suit either	imperial said
but the board said it was n't interested for now	but the board said
but navigation mixte is loosely held and hard to defend	but navigation mixte is loosely held and hard
he 's the kind of guy who rescues trampled flags	he 's the kind of guy
at least once an episode we see protestors marching around screaming slogans	at least once an episode we see protestors marching around
the scars will be here years after the polls close	the scars will be here
now that 's advice the writers should take to heart	now that 's advice
he succeeds c. benjamin brooks jr. who will retire nov. 1	he succeeds c. benjamin brooks jr.
mr. sorrell traveling in the far east could n't be reached	mr. sorrell could n't be reached
i think mr. phillips is going to need some help	i think
investors dumped stocks of big companies whose earnings fluctuate with the economy	investors dumped stocks of big companies
she said that impact ca n't be reasonably assessed yet	she said
chemical earnings fell 10 % reflecting softening of demand	chemical earnings fell 10 %
nobody has the right to tell me how much i can work	nobody has the right to tell me
the company deliberately understaffs stretching employees ' schedules to the limit	the company deliberately understaffs
labor problems are the last thing mr. smith needs right now	labor problems are the last thing
when the pilots refused the company retracted it	the company retracted it
he said mr. steinberg had insisted that the merger talks move quickly	he said
i do n't think that is the case	i do n't think
mexican officials maintain the japanese reserve is only a result of unfamiliarity	mexican officials maintain
it is hoped that other japanese would then follow the leader	it is hoped
he begins his seven-year term nov. 9 succeeding kenan evren	he begins his seven-year term nov. 9
mr. edelman said the decision has nothing to do with marty ackerman	mr. edelman said
bond prices fell after the chicago report was released	bond prices fell
mr. carmichael said investors also demanded stricter convenants	mr. carmichael said
if we had it might have scared us off he says	it might have scared us off he says
as this is now a litigation matter we have no further comment	we have no further comment
what i hope to bring to this is another word process	is another word process
adds mr. eidsmo what felt good that day was done that day	adds mr. eidsmo was done that day
hoping to stay ahead of the pack the company is emphasizing innovation	the company is emphasizing innovation
sea containers which unveiled a proposed restructuring advanced 1 to 62	sea containers advanced 1 to 62
santa fe pacific was the kind of story wall street loved	santa fe pacific was the kind of story
that was another reason the street loved santa fe	that was another reason
but value it turns out is only what a buyer will pay	but value it turns out is only
but it is n't clear why that should be so	but it is n't clear
that indicates speculators are betting a higher offer is in the wings	that indicates
that 's what happened yesterday	that 's
i 'm hopeful that we 'll have further discussions mr. hahn said	i 'm hopeful mr. hahn said
the board has 10 business days to respond	the board has 10 business days
if bringing the message is a crime i 'm guilty of it	i 'm guilty of it
we are looking for representation we have n't had a specialist said	we are looking for representation a specialist said
it is widely expected that they will	it is widely expected
some even claim the group has become a lagging not leading indicator	some even claim
florida national said yesterday that it remains committed to the merger	florida national said yesterday
after all gold prices usually soar when inflation is high	after all gold prices usually soar
that 's just what joseph granville expects	that 's
you go into them because they move counter to the general market	you go into them
management and labor worry that the gap makes u.s. companies less competitive	management and labor worry
mr. kakita said the key dollar-yen exchange rate is at 135 yen	mr. kakita said
istat said 369,000 more people were employed in july than in april	istat said
he also said investment by businesses is falling off	he also said
but some analysts say salomon has turned the corner	but some analysts say
analysts say investors remain skittish toward salomon because of its volatile earnings	analysts say
and they say the outlook for 1990 is nearly as bad	and they say
previously airlines were limiting the programs because they were becoming too expensive	previously airlines were limiting the programs
one airline executive who declined to be identified called the loss amazing	one airline executive called the loss amazing
it means we 're eating into the bread that keeps us going	it means
u.s. officials however said they are n't buying the israeli argument	u.s. officials however said
a u.s. counterterrorism official said experts are studying the israeli list	a u.s. counterterrorism official said
deciding what constitutes terrorism can be a legalistic exercise	deciding can be a legalistic exercise
in birmingham which is 57 % black whites are the minority	in birmingham whites are the minority
needless to say he was talking about rico	he was talking about rico
during the summer wang executives had said they might seek outside investment	during the summer wang executives had said
as usual the over-the-counter market 's biggest technology stocks were hardest hit	the over-the-counter market 's biggest technology stocks were hardest hit
when industries were weak it protected them	it protected them
the rest of the world accepted such methods when japan was developing	the rest of the world accepted such methods
taken by surprise the socialist party is busy changing its doctrines	taken by surprise the socialist party is busy
magazine editors did not take the criticisms lying down	magazine editors did not take the criticisms
in houston we have seen how bad the housing problem can become	in houston we have seen
the irs will pay if its error burdens you with bank charges	the irs will pay
it held that testa is taxable on 44,400 of unreported income	it held
why be a middleman for charitable gifts a retiree asks	a retiree asks
so he asked the irs if the plan would work	so he asked the irs
men would crawl in the sand looking for shiny stones	men would crawl in the sand
ghost towns dot the namib dunes proving diamonds are n't forever	ghost towns dot the namib dunes
the wind stinging with sand never seems to stop	the wind never seems to stop
they figure it 's not a very good advert	they figure
it 's unclear how much rates can fall and how soon	it 's unclear
cray made its announcement after the stock market closed	cray made its announcement
but as you may know things are not going well for violetta	but things are not going well for violetta
there are times when she must show a little emotion	there are times
this is the most moving traviata i 've ever seen	this is the most moving traviata
i wish he could wear lifts in his voice	i wish
with the market overbuilt builders are finding limited opportunities and increased risks	builders are finding limited opportunities and increased risks
so developers are saying they will look into distressed properties	so developers are saying
the u.s. contends that the rules are n't justified on health grounds	the u.s. contends
westinghouse electric corp. said it will buy shaw-walker co	westinghouse electric corp. said
he also questioned whether recent gains in that country can be sustained	he also questioned
it said it would purchase the stock at market price	it said
if bluebloods wo n't pay high prices for racehorses anymore who will	who will
analysts said they expected the action and investors applauded the move	analysts said and investors applauded the move
it does n't look nice on the outside while getting mealy inside	it does n't look nice on the outside
it did shaking the apple establishment to its roots	it did
here 's a waltana he exclaims picking one off a tree	here 's a waltana he exclaims
once somebody eats one they get hooked	they get hooked
the fuji to be sure has blemishes too	the fuji has blemishes too
pepsi said it will spend 10 million advertising the promotion	pepsi said
here is the red tape that irks surveyed business owners the most	here is the red tape
honeywell said a second sale of yamatake-honeywell is still being negotiated	honeywell said
mr. bakker said he was guilty of sin but not fraud	mr. bakker said
but recent events indicate that federal credit is out of control	but recent events indicate
hers is a hand that will test the mettle of her audiences	hers is a hand
talk hurts from where it spurts one of them says	talk hurts from one of them says
jaguar finished 4 lower at 694	jaguar finished at 694
elsewhere share prices closed lower in zurich amsterdam milan and stockholm	elsewhere share prices closed in zurich amsterdam milan and stockholm
one was so fantastic in appearance it was dubbed hallucigenia	one was so fantastic in appearance
analysts estimated that sales at u.s. stores declined in the quarter too	analysts estimated
shortageflation as economists have come to call it had gone hyper	shortageflation had gone hyper
the young farmer makes money on the few hogs he sells here	the young farmer makes money on the few hogs
i do n't know why	i do n't know
at closing time farmers cart out most of what they carted in	at closing time farmers cart out most of
try as they might the communists could neither replace nor break him	the communists could neither replace nor break him
the young leave especially girls who wo n't milk cows by hand	the young leave especially girls
if nobody buys i bring my prices down	i bring my prices down
but the meat-processing machines he picked up are 50 years old	but the meat-processing machines are 50 years old
if the situation changes i 'll get stuck with them	i 'll get stuck with them
we do n't know how to get from socialism to capitalism	we do n't know
that 's what the naczelnik counts on	that 's
every time he sees me he gets very nervous	every time he gets very nervous
he ca n't guarantee that he can use it any better	he ca n't guarantee
but there was no way to prove dr. knudson 's two-hit theory	but there was no way
but he did n't know which gene or genes had disappeared	but he did n't know
where these discoveries will lead scientists can only speculate	scientists can only speculate
if convicted they could be sentenced to death	they could be sentenced to death
they also established an office to control government and party finances	they also established an office
edison said the acquired stores would be integrated into its current operations	edison said
allianz did n't say whom if anyone it will support	allianz did n't say
and some fund groups said investors actually became net buyers	and some fund groups said
analysts say additional investors transferred their assets into money funds this month	analysts say
one trend that continues is growth in the money invested in funds	one trend is growth in the money invested in funds
we think that the ratings revision is unfortunate but not unexpected	we think
the sales pitch might n't be as farfetched as it seems	the sales pitch might n't be as farfetched
and what they have shown is n't impressive	and is n't impressive
so we all stand to benefit if patient-physician relations become a partnership	so we all stand to benefit
the irs may taketh what the labor department giveth	the irs may taketh
executives universally believe workers should know their employer-sponsored benefits	executives universally believe
i 'm ashamed i own the stupid thing	i 'm ashamed
half of those surveyed said they simply walk these days for exercise	half of those surveyed said
the second is they do n't have enough discipline	the second is
it 's hard to know if people are responding truthfully	it 's hard to know
people are too embarrassed to say they have n't done anything	people are too embarrassed to say
most people said they exercise both for health and enjoyment	most people said
working with lawyers she says i need it	she says i need it
the emotional aspect is so draining they needed a good workout	the emotional aspect is so draining
we keep wondering what mr. gates wanted to say	we keep wondering
the controls on cooperatives appeared relatively liberal when first introduced	the controls on cooperatives appeared relatively liberal
all nasdaq industry indexes finished lower with financial issues hit the hardest	all nasdaq industry indexes finished lower
the bank said the talks resulted from solicitations by its financial adviser	the bank said
daimler said it has had talks with jaguar about possible joint ventures	daimler said
but mr. runkel contends there has been no exodus of strike-force lawyers	but mr. runkel contends
at the time the plan was announced there were 135 lawyers	at the time there were 135 lawyers
i do n't think the reorganization is going to happen	i do n't think
do you think the british know something that we do n't	do you think
the offer is scheduled to expire on nov. 28 unless extended	the offer is scheduled to expire on nov. 28
but on oct. 6 he had reason to celebrate	but on oct. 6 he had reason
valued at 1.3 million it was part of a four-crate shipment	it was part of a four-crate shipment
traders said most municipal bonds ended 1\/2 point higher	traders said
so far all the studies have concluded that ru-486 is safe	so far all the studies have concluded
one might well ask why bother with this drug at all	one might well ask
please contribute what you can the ad said	please contribute the ad said
the ultimate form of charity is when you do n't tell anyone	the ultimate form of charity is
he felt we should be giving something back	he felt
he adds i think this is a great strategic move for quebecor	he adds i think
they are buying an operation that is running well	they are buying an operation
what counts is the bottom line	is the bottom line
dozens of small companies did swiftly establishing a standard operating system	dozens of small companies did
critics also say american companies charge too much	critics also say
he said he has not met with representatives from acadia	he said
they want to pretend it does n't exist he said	they want to pretend he said
that is a property right that belongs to the performer	that is a property right
i 'm not sure he 's explained everything mrs. stinnett says grudgingly	i 'm not sure mrs. stinnett says grudgingly
mr. baker promises to return if the haunting continues	mr. baker promises to return
i tell people it 's the groundup bones of saints he says	i tell people he says
this time though he says i think we got it	this time though he says i think
mr. conn charges that humana 's own actions undermine its argument	mr. conn charges
they 're looking for something that 's very safe	they 're looking for something
declines came because of concern that demand for copper may slow down	declines came because of concern
i feel sorry for whoever wins says a brazilian diplomat	i feel sorry for says a brazilian diplomat
who that winner will be is highly uncertain	is highly uncertain
and where we are is bad	and is bad
officials also say a national electricity shortage might not be far off	officials also say
they said the problems are n't safety related	they said
ford said the new offer will begin saturday and run indefinitely	ford said
yesterday 's edition did n't specify where the improvement would take place	yesterday 's edition did n't specify
dpc said it could n't comment on the suit	dpc said
known as easy eggs the product has disappointed investors	the product has disappointed investors
you went to college and thought you got an education	you went to college and thought
but sponsors might not pick the stocks that will match the market	but sponsors might not pick the stocks
polymerix makes lumber-like materials that it describes as plastic wood	polymerix makes lumber-like materials
martin schrager 51 who had been president was named vice chairman	martin schrager 51 was named vice chairman
typical of other experiments mr. oriani said his experiment was very erratic	mr. oriani said
the 49-nation organization meeting in malaysia called for tighter financial pressure immediately	the 49-nation organization called for tighter financial pressure immediately
who knows how much they 'll be worth 100 years from now	who knows
i do n't think the checks are worth 15 apiece he says	i do n't think he says
the independent-contractor project which began in 1988 involves about 350 irs agents	the independent-contractor project involves about 350 irs agents
not everyone believes that the good times are over for shippers	not everyone believes
it arrived just as the regulator handling such operations was retiring	it arrived
most important hospital admission rates are stabilizing after several years of decline	hospital admission rates are stabilizing after several years of decline
that 's what they 're after	that 's
the dollar posted gains in quiet trading as concerns about equities abated	the dollar posted gains in quiet trading
the company said it believes the suit is without merit	the company said
traders said a variety of factors triggered the rally	traders said
outstanding contracts are those that remain to be liquidated	outstanding contracts are those
he also says he is losing money now	he also says
one stuck to old-line business traditions while the other embraced the change	one stuck to old-line business traditions
high-end u.s. furriers say these imports have n't squeezed them	high-end u.s. furriers say
inspired by imports mr. rosen now makes fur muffs hats and flings	mr. rosen now makes fur muffs hats and flings
he says it accounts for 25 % of total sales	he says
and those who did n't move some production overseas suffer labor shortages	and those suffer labor shortages
but mr. rosen responds whatever people want to buy i 'll sell	but mr. rosen responds i 'll sell
at&t also said net income rose 19 % in the third quarter	at&t also said
at&t said the special retirement option will increase fourth-quarter expenses	at&t said
he said unfavorable currency translations were also a factor in the quarter	he said
most brokers assume that all orders are day orders unless specified otherwise	most brokers assume
winners outpaced losers 572 to 368 while 181 issues remained unchanged	winners outpaced losers 572 to 368
dealers said it was hit by some profit-taking after gains since mid-week	dealers said
they said the price would be around 10 million	they said
silver however is in a deeper slump than are gold and platinum	silver however is in a deeper slump
yet if gold prices improve silver prices could rally sharply he says	yet silver prices could rally sharply he says
i do n't think there 's anyone not building one	i do n't think
1 make sure you have a strong personnel department	1 make sure
coach them in handling complaints so that they can resolve problems immediately	coach them in handling complaints
3 decide whether you want a panel system or a single adjudicator	3 decide
all anyone need do is hang up a shingle and start planning	all is hang up a shingle and start planning
simply put there is n't enough business for every store to grow	there is n't enough business
mcdonald 's has also been running negative all year the analyst says	mcdonald 's has also been running all year the analyst says
the plan is talking about applicants admitted not students who enroll	the plan is talking about applicants admitted not students
you know who you are	you know
but with every step i take i 'm building wealth	but with every step i 'm building wealth
you can too if you like me refuse to bite the bullet	you can too
he added that olivetti will continue making its lsx minicomputer line	he added
for those who delight in the misfortune of others read on	for those read on
once they size them up then they know what buttons to push	then they know
for some investors it 's the appearances that leave them deceived	for some investors it 's the appearances
conservative appearances make people think it 's a conservative investment	conservative appearances make people think
they say the broker took them out for lunch frequently	they say
he urged them to refer their friends who also lost money	he urged them to refer their friends
nick cortese thinks that 's what happened to him	nick cortese thinks
and they eyeball types of risk that are not easily quantified	and they eyeball types of risk
to be sure the program has n't completely stalled	the program has n't completely stalled
beta figures are widely available and easy to interpret	beta figures are widely available and easy
cautious investors should generally go with stocks that have low betas	cautious investors should generally go with stocks
remember though that beta also has important limitations	remember though
with krenz we just do n't know what to expect	with krenz we just do n't know
the most important thing is that he have a chance	the most important thing is
he was later shown on television fielding questions	he was later shown on television
but if he 's sharp and quick he has a chance	but he has a chance
the diplomat adds that mr. krenz has several things going for him	the diplomat adds
either way i have a problem with how quickly he 's changed	either way i have a problem with
just wait until you 're a bit older	just wait
tuesday the shares regained skr20 closing at skr225	tuesday the shares regained skr20
but we certainly like what we 've seen so far	but we certainly like
so term insurance may not be as cheap as it looks	so term insurance may not be as cheap
congress closed this loophole last year or thought it did	congress closed this loophole last year or thought
hugely popular it is far more flexible than straight whole life	it is far more flexible than straight whole life
the spokesman said maxicare hopes to complete the reorganization by early 1990	the spokesman said
americans are expected to conform to the japanese culture when in japan	americans are expected to conform to the japanese culture
but the japanese insist upon japanese managers everywhere they set up shop	but the japanese insist upon japanese managers everywhere
mr. kageyama is accurate to deny a specific anti-american bias	mr. kageyama is accurate
people wonder what 's going to happen next	people wonder
what happens to me if campeau collapses between now and then	what happens to me
the campeau situation is a little uncertain and very difficult to analyze	the campeau situation is a little uncertain and very difficult
i 'm going to ship and hope i get paid	i 'm going to ship and hope
if i need to ask for money up front later i will	i will
the stores they work for may be sold	the stores may be sold
what that will mean for manufacturers is anybody 's guess	is anybody 's guess
it has never been interested in what we think	it has never been interested in
amdahl 's results were somewhat worse than expected	amdahl 's results were somewhat worse
he said all three non-food operations are profitable	he said
volume totaled 132.1 million shares which is about average for the year	volume totaled 132.1 million shares
of the 4,348 issues that changed hands 1,074 advanced and 866 declined	of the 4,348 issues 1,074 advanced and 866 declined
tokyu is one of the potential buyers who might raise its hand	tokyu is one of the potential buyers
trustee who monitored settlement payments to dalkon shield claimants quits	trustee quits
coniston said it would pursue various financing alternatives	coniston said
delmed said robert s. ehrlich resigned as chairman president and chief executive	delmed said
gorbachev said moscow wo n't intervene in east bloc moves to democracy	gorbachev said
the action came after the senate approved the house-passed measure	the action came
thank goodness it 's happening	thank goodness
her son healthy and symptom-free currently takes no medication	her son currently takes no medication
there 's no finger to be pointed she said	there 's no finger she said
estimates suggest october 's figure may be even higher	estimates suggest
several cotton analysts said that the move appeared to be mostly technical	several cotton analysts said
the modest sell-off which started on tuesday continued	the modest sell-off continued
the agency noted however the estimate will likely be confirmed	the agency noted however
one individual said the shareholders ' accord was well worked out	one individual said
he added that hopefully lin will conduct a fair auction	he added
the unit said it can provide no assurance a transaction will occur	the unit said
the cbs official said that price sounded fine	the cbs official said
while rights fees head skyward ad rates wo n't	ad rates wo n't
the billion-dollar question is how much are those benefits worth	the billion-dollar question is
cbs is likely to spend whatever it takes to keep them	cbs is likely to spend
our competitors say we overbid them	our competitors say
maybe we recognize values the other guys do n't mr. pilson says	maybe we recognize values mr. pilson says
mr. pilson 's major events strategy jelled after mr. tisch took over	mr. pilson 's major events strategy jelled
if the show ai n't a killer they 're gone	they 're gone
moreover sports is hardly the best way to lure adult women	moreover sports is hardly the best way
nor is cbs a shoo-in to get blockbuster ratings	nor is cbs a shoo-in
it 's too early to tell what happens after that he says	it 's too early to tell he says
if the playoffs end in four-game sweeps losses could soar	losses could soar
advertisers are resisting higher prices which would help close the gap	advertisers are resisting higher prices
other admen however say rates could rise later if ad spending surges	other admen however say
that 's the only question we need to address	that 's the only question
today mr. corry presides over a company whose fortunes have changed abruptly	today mr. corry presides over a company
but the fiercely competitive mr. corry quickly showed he 's no pushover	but the fiercely competitive mr. corry quickly showed
when negotiating mr. corry played his cards close to the vest	mr. corry played his cards close to the vest
people got rich through takeovers in those days as they do today	people got rich through takeovers in those days
eavesdropping by individuals is harder to measure	eavesdropping by individuals is harder
still radio shack is aware that some of its products are controversial	still radio shack is aware
and ibm said it expects the costs to continue climbing	and ibm said
this is how american women won the right to vote	this is
the trend is making proponents less optimistic a tax cut will pass	the trend is making proponents less optimistic
unless he changes they lose said a democratic leadership aide	they lose said a democratic leadership aide
i happen to think it was right mr. bush said flatly	i happen to think mr. bush said flatly
once one japanese company steps up its investments the whole industry follows	the whole industry follows
if excess capacity develops they say not everyone will suffer	they say not everyone will suffer
tw 's junk bonds were n't as junk bonds go unusually weak	tw 's junk bonds were n't unusually weak
people said they did n't think a billion-dollar deal would trade	people said
as he sums it up we are listening to the market	we are listening to the market
we do n't think this will affect that	we do n't think
other losing issues included showa shell which fell 40 to 1,520	other losing issues included showa shell
sekisui house which gained 150 tuesday lost 70 to 2640	sekisui house lost 70 to 2640
there was little turnover and nothing to stimulate the market	there was little turnover and nothing
deutsche bank plummeted 12 to 645 hurt by the general mood	deutsche bank plummeted 12 to 645
the london times said she had contravened protocol	the london times said
as usual her sin was saying what she thought	as usual her sin was saying
the beebes alleged that toxic fumes from the carpets made them sick	the beebes alleged
the beebes have not yet decided whether to appeal	the beebes have not yet decided
the two that remain have n't yet reached the pre-trial fact-finding stage	the two have n't yet reached the pre-trial fact-finding stage
but developers of four planned office towers cautioned that obstacles still remain	but developers of four planned office towers cautioned
mr. ahmad 's lawyer said he would appeal	mr. ahmad 's lawyer said
lawyers close to the case said they believed the ruling was unprecedented	lawyers close to the case said
we know it 's there	we know
to be sure the threat has hit home down here	the threat has hit home down here
also rather than increase supplies they reduce them and encourage hoarding	also they reduce them and encourage hoarding
maybe he thinks they should also sell to the highest bidder	maybe he thinks
mr. laband should beware since he lives in south carolina	mr. laband should beware
having been through several tornadoes and hurricanes i have a different perspective	i have a different perspective
we suspect voters are fed up with the finagling	we suspect
cincinnati bell inc. said net declined 1.8 %	cincinnati bell inc. said
i want to publish one that succeeds said mr. lang	i want to publish one said mr. lang
mr. lang feels that time 's priorities changed	mr. lang feels
there is plenty of work to be done on what we have	there is plenty of work
the software company said revenue slid 28 % to 53.9 million	the software company said
explains a sotheby 's spokeswoman the statement means exactly what it says	explains a sotheby 's spokeswoman the statement means
more recently sotheby 's has predicted the collection will fetch 140 million	more recently sotheby 's has predicted
some tariffs were eliminated when the trade pact took effect jan. 1	some tariffs were eliminated
we think everything will go this way in a few years	we think
one is the panic the earthquake in san francisco which is positive	one is the panic the earthquake in san francisco
business was slow because many companies were closed yesterday	business was slow
he succeeds william kohut who resigned earlier this year	he succeeds william kohut
the bill must be enacted before the cuts can be restored	the bill must be enacted
there 's no shortage of major things to do he said	there 's no shortage of major things he said
while the book amply justifies its subtitle the title itself is dubious	the title itself is dubious
advancing issues outnumbered decliners 821-201 with 103 unchanged	advancing issues outnumbered decliners 821-201
construction shares that gained included shimizu which rose 130 to 2,080	construction shares included shimizu
racal electric which traded 11 million shares declined 12 to 218	racal electric declined 12 to 218
shortage and crisis became buzz words although neither really applied	shortage and crisis became buzz words
what the arabs started inflation finished	inflation finished
par said it is cooperating in the investigation	par said
but secretary skinner said he would urge bush to veto the bill	but secretary skinner said
cincinnati microwave inc. said it introduced two radar detectors	cincinnati microwave inc. said
the decision was announced after trading ended	the decision was announced
rep. bates said he would write the letters as ordered	rep. bates said
there may be forces that would delay this scenario	there may be forces
ideologues are the last to surrender and germans are an ideological people	ideologues are the last and germans are an ideological people
having donated heavily to museums they demand a place on their boards	they demand a place on their boards
we tell them all the major companies are having financial difficulties	we tell them
show it 's business as usual	show
the university is considering installing a 250,000 system to store applications electronically	the university is considering installing a 250,000 system
mr. tait say he does n't blame lilly	mr. tait say
when a company realizes that it 's hard to go with wang	it 's hard to go with wang
you think you can go out and turn things around	you think
it 's a tough thing when you ca n't	it 's a tough thing
a 300-year-old play may be easier to revive than one merely 25	a 300-year-old play may be easier than one merely 25
the companies just gave back what they had reserved for he said	the companies just gave back he said
the worst-case scenario would be if the put expires worthless	the worst-case scenario would be
the accompanying table shows how this strategy would work for three stocks	the accompanying table shows
but while index options are convenient they have several disadvantages	but they have several disadvantages
mr. sherry declined to comment when asked about the sales	mr. sherry declined to comment
a company spokesman said he could n't explain their sudden bullishness	a company spokesman said
pricing cycles to be sure are nothing new for plastics producers	pricing cycles are nothing new for plastics producers
now producers hope prices have hit bottom	now producers hope
still quantum has a crisis to get past right now	still quantum has a crisis right now
some analysts speculate the weakening stock may yet attract a suitor	some analysts speculate
but fund managers say they 're ready	but fund managers say
many fund managers argue that now 's the time to buy	many fund managers argue
several fund managers expect a rough market this morning before prices stabilize	several fund managers expect a rough market this morning
she added if they all were bullish i 'd really be upset	she added
this time i do n't think we 'll get a panic reaction	this time i do n't think
when selling is so frenzied prices fall steeply and fast	prices fall steeply and fast
another big question hovering over the debate is what president bush thinks	another big question hovering over the debate is
mr. bentsen said he hopes the senate will consider that measure soon	mr. bentsen said
sen. dole said that the move required sacrifice by every senator	sen. dole said
a p&g spokeswoman confirmed that shipments to phoenix started late last month	a p&g spokeswoman confirmed
ideal said it expects to complete the transaction early next year	ideal said
when it went down by all tradition the economy followed	by all tradition the economy followed
surveys suggested that consumer confidence was high before friday	surveys suggested
the prosperity that followed black monday permits a more optimistic view today	the prosperity permits a more optimistic view today
in leipzig activists vowed to continue street protests to demand internal change	in leipzig activists vowed to continue street protests
is this the wrong time to open a store	is this the wrong time
certainly the recent drop in prices does n't mean manhattan comes cheap	certainly the recent drop in prices does n't mean
it makes investment castings and has traded over-the-counter	it makes investment castings and has traded
the pharmaceuticals maker had traded over-the-counter	the pharmaceuticals maker had traded
i think it was a little premature on their part	i think
several traders could be seen shaking their heads when the news flashed	several traders could be seen shaking their heads
and i think a lot of people will harp on program trading	and i think
the big board 's mr. grasso said our systemic performance was good	the big board 's mr. grasso said
i do n't think their customers would like it very much	i do n't think
just thought you 'd like to know	just thought
mr. spielvogel said he would n't launch a hostile bid	mr. spielvogel said
weatherford said market conditions led to the cancellation of the planned exchange	weatherford said
european drama has had better though still mixed fortunes	european drama has had better fortunes
how such remarks translate into policy wo n't become clear for months	wo n't become clear for months
she highlighted exclusionary business practices that the u.s. government has identified	she highlighted exclusionary business practices
but she stressed i am against managed trade	but she stressed
they painted the apartment orange pink and white according to her instructions	they painted the apartment according to her instructions
i thought this was all taken care of in the music man	i thought
the gains to be sure are rather small	the gains are rather small
this does n't mean they 're less likely to live alone however	this does n't mean however
as people get even older many become widowed	many become widowed
twenty percent do n't even feel they are financially well off	twenty percent do n't even feel
about 40 % do n't feel they 're more able than others	about 40 % do n't feel
does this signal another black monday is coming	does this signal
if you 're a technician you obey the signals	you obey the signals
so she thinks the damage will be short-lived and contained	so she thinks
this is exactly the same thing as far as i 'm concerned	this is exactly the same thing as far
over the next several months though he says things look bad	over the next several months though he says
i think the market will be heading down into november he says	i think he says
i guess that 's my forecast	i guess
i do n't think the market is going through another october '87	i do n't think
nevertheless he says a depression does n't appear likely	nevertheless he says
if not we could go to 2200 very soon	we could go to 2200 very soon
t-bills probably are the right place to be he says	t-bills probably are the right place he says
where 's the guy who can say enough is enough	where 's the guy
he expects to invest the rest if the market weakens further	he expects to invest the rest
it can happen before you can turn around	it can happen
i think it will be a rigor mortis rally he said	i think he said
i thought your editorial was factually accurate and deliberately elucidative	i thought
he used about 56 words defending the witnesses ' constitutional rights	he used about 56 words
my colleagues and i fully realize we are not a court etc	my colleagues and i fully realize etc
how was that practice referred to when i was in school	how was that practice referred to
everything that mr. lantos says in his letter is partially true	everything is partially true
cbs will continue to program action-adventure shows to follow the sajak hour	cbs will continue to program action-adventure shows
whether it 's 5 billion or 3.5 billion it does n't matter	it does n't matter
analysts and competitors however doubt the numbers were that high	analysts and competitors however doubt
budget said its frequent-flier costs are substantially below avis 's level	budget said
but it 's uncertain whether these institutions will take those steps	but it 's uncertain
canadian investment rules require that big foreign takeovers meet that standard	canadian investment rules require
they market cable-tv on the very grazing opportunities cnn seeks to discourage	they market cable-tv on the very grazing opportunities
and i think institutions are going to come in and buy	and i think
if i sell now i 'll take a big loss	i 'll take a big loss
when the little guy gets frightened the big guys hurt badly	the big guys hurt badly
i just stopped by to see how much i would have lost	i just stopped by to see
when it comes to money once bitten 2,000 times shy	2,000 times shy
diamond shamrock offshore partners said it had discovered gas offshore louisiana	diamond shamrock offshore partners said
they learned they could survive it without much problem	they learned
in that case there will be plenty of blame to go around	in that case there will be plenty of blame
ferruzzi has denied it was trying to manipulate the soybean futures market	ferruzzi has denied
inland said its third-quarter results will be announced later this week	inland said
grumman corp. received an 18.1 million navy contract to upgrade aircraft electronics	grumman corp. received an 18.1 million navy contract
people are fast leaving the place where he is stuck	people are fast leaving the place
but these are not the differences that make headlines	but these are not the differences
it 's worth noting that both disapproving relatives are immigrants	it 's worth noting
it said analysts had been expecting a small profit for the period	it said
skipper 's said the merger will help finance remodeling and future growth	skipper 's said
hughes said it expects the sale to close by year end	hughes said
we 're about to see if advertising works	we 're about to see
it would have been too late to think about on friday	it would have been too late on friday
we do n't think at this point anything needs to be said	we do n't think at this point
that 's good news because we all swim in this water	that 's good news
but if you make a request you should support the committee	but you should support the committee
i do n't think anyone left the place whistling dixie	i do n't think
shares of three brokerage firms rose after they reported earnings	shares of three brokerage firms rose
mr. phelan expressed relief that the market rebounded yesterday	mr. phelan expressed relief
it was the opposite of what happened on oct. 19	it was the opposite of
we have sufficient cash flow to handle that he said	we have sufficient cash flow he said
if you guessed black-and-white snapshots you 're right	you 're right
one big obstacle is that few drugstores develop the film anymore	one big obstacle is
but when stocks began to climb instead prices of treasury bonds declined	but prices of treasury bonds declined
in fact some economists contend that the latest easing started last week	in fact some economists contend
some traders said the high-yield market was helped by active institutional buying	some traders said
but as japanese stocks rebounded treasurys retreated and ended just modestly higher	but treasurys retreated and ended just modestly higher
foreign bonds surged as the dollar weakened against most major currencies	foreign bonds surged
and it 's important that we be accurate	and it 's important
but in the end customers ' wishes are what will prevail	but in the end customers ' wishes are
big bear does n't care for disposable diapers which are n't biodegradable	big bear does n't care for disposable diapers
it is impossible to know whether that theory is realistic	it is impossible to know
what happened friday was the worst of all worlds	was the worst of all worlds
as liquidity on that market weakened prices fell sharply	prices fell sharply
it also rose last friday while the stock market sagged	it also rose last friday
is this what the home builders want	is this
but they search for ways to limit the damage	but they search for ways
deal stocks led the market down as they absorbed the heaviest losses	deal stocks led the market down
not only californians but all americans would pay if this thing passed	not only californians but all americans would pay
this is the state that recently passed the prop. 65 anti-toxic initiative	this is the state
a spokesman said the company had sales of 400 million in 1988	a spokesman said
as wall street strengthened the london trading room went wild	the london trading room went wild
traders shouted as their screens posted an ever-narrowing loss on wall street	traders shouted
rally rally rally shouted shearson trader andy rosen selling more jaguar shares	rally rally rally shouted shearson trader andy rosen
results were released after the market closed	results were released
junk bonds also recovered somewhat though trading remained stalled	junk bonds also recovered somewhat
east germans rallied as officials reportedly sought honecker 's ouster	east germans rallied
five african nations however said they would continue selling the valuable tusks	five african nations however said
prices in brussels where a computer breakdown disrupted trading also tumbled	prices in brussels also tumbled
following is a breakdown of major market activity	is a breakdown of major market activity
the rating agency said about 85 million in securities was affected	the rating agency said
a spokesman said 2.6 million shares have been purchased since then	a spokesman said
telerate has rejected the offer which expires nov. 3	telerate has rejected the offer
at first it seemed as if history might repeat itself	at first it seemed
overall more big board stocks lost money than gained	overall more big board stocks lost money
what we had was a real old-fashioned rally	was a real old-fashioned rally
i much prefer money i can put my hands on	i much prefer money
you know what the law of averages is do n't you	you know do n't you
that 's not an average to soothe giant rooters	that 's not an average
i 'm for the giants today but only because they lost yesterday	i 'm for the giants today but
alliant said it plans to use the microprocessor in future products	alliant said
