not everybody agrees that it 's time to trim	not everybody agreed that it was time to trim
people hold out and try to get a bargain	people held out and try to get a bargain
pricing cycles to be sure are nothing new for plastics producers	pricing cycles to be sure were nothing new for plastics producers
but not every company expects to report increased earnings	but not every company expected to report increased earnings
their discomfort is a healthy sign for the rest of us	their discomfort was a healthy sign for the rest of us
it 's also a fast fix for an ailing image	it was also a fast fix for an ailing image
bigger business can often better afford to minimize the cost of crime	bigger business could often better afford to minimize the cost of crime
actually the funds do fluctuate but beyond the third decimal place	actually the funds did fluctuated but beyond the third decimal place
once you 're miss america you 're always miss america	once you were miss america you were always miss america
his entry-price condos are labeled society hill	his entry-price condos were labeled society hill
of course that is n't really the case	of course that was n't really the case
but the complex language is n't the only reason	but the complex language was n't the only reason
he believes in what he plays and he plays superbly	he believed in what he played and he played superbly
lawyers remain divided about whether anything is wrong with all this	lawyers remained divided about whether anything was wrong with all this
a.p. green currently has 2,664,098 shares outstanding	a.p. green currently had 2,664,098 shares outstanding
lee dirks & associates is to sell the chains	lee dirks & associates was to sell the chains
as usual the green lobby 's proposal is disconnected from scientific reality	as usual the green lobby 's proposal was disconnected from scientific reality
accord prices start at 12,345	accord prices started at 12,345
two bills in congress hope to make such restrictions national	two bills in congress hoped to make such restrictions national
the expansion is subject to approval by federal and wisconsin environmental regulators	the expansion was subject to approval by federal and wisconsin environmental regulators
but the rockefeller investment is its largest	but the rockefeller investment was its largest
it expects a 1.42 billion quarterly loss	it expected a 1.42 billion quarterly loss
it helps to keep out unions	it helped to keep out unions
the offering series 1989-83 is backed by fannie mae 9 % securities	the offering series 1989-83 was backed by fannie mae 9 % securities
it plans to sell 1,700 units in 1989	it planned to sell 1,700 units in 1989
get off your he would bellow say the authors	got off your he would bellow said the authors
japan is a major target for the soviets	japan was a major target for the soviets
but stock-index futures have plenty of support	but stock-index futures had plenty of support
they are becoming more independent	they were becoming more independent
much of what we set out to do is completed	much of what we set out to do was completed
most economists expect the slowing u.s. economy to curb demand for imports	most economists expected the slowing u.s. economy to curb demand for imports
having been through several tornadoes and hurricanes i have a different perspective	having been through several tornadoes and hurricanes i had a different perspective
is there really a commitment or an illusion of activity he asks	is there really a commitment or an illusion of activity he asked
but that partner is n't fiat	but that partner was n't fiat
the uaw is seeking a hearing by the full 14-judge panel	the uaw was seeking a hearing by the full 14-judge panel
the only question is how deep is it going to be	the only question was how deep is it going to be
mr. jones calls the ranch the pentagon of sportdom	mr. jones called the ranch the pentagon of sportdom
new entitlements tend to grow creating a rationale for new taxes	new entitlements tended to grow creating a rationale for new taxes
wisconsin toy has 71 retail stores primarily in discount settings	wisconsin toy had 71 retail stores primarily in discount settings
risc technology speeds up a computer by simplifying the internal software	risc technology speeded up a computer by simplifying the internal software
the babelists of the united nations are experts at obfuscation	the babelists of the united nations were experts at obfuscation
that 's not what our fathers had in mind	that was not what our fathers had in mind
the anthers in these plants are difficult to clip off	the anthers in these plants were difficult to clip off
that effect holds true for both short-term and long-term bonds	that effect held true for both short-term and long-term bonds
in such an environment a market maker can absorb huge losses	in such an environment a market maker could absorb huge losses
the government is funding several projects to push pc use	the government was funding several projects to push pc use
but how much will shoppers benefit	but how much will shoppers benefitted
they carry a 7 % coupon	they carryed a 7 % coupon
shortageflation as economists have come to call it had gone hyper	shortageflation as economists had come to call it had gone hyper
the market during the start-up is estimated at 25,000 subscribers	the market during the start-up was estimated at 25,000 subscribers
there 's no finger to be pointed she said	there was no finger to be pointed she said
the notebook the ti model 12 will be priced at 4,199	the notebook the ti model 12 bed priced at 4,199
several fund managers expect a rough market this morning before prices stabilize	several fund managers expected a rough market this morning before prices stabilized
travelers up to age 99 get a percentage discount matching their age	travelers up to age 99 got a percentage discount matching their age
it also is trying to shore up its tobacco business	it also was trying to shore up its tobacco business
his election increases ryder 's board to 14 members	his election increased ryder 's board to 14 members
take heart sports fans he wrote	took heart sports fans he wrote
mr. lurie is currently co-chief executive	mr. lurie was currently co-chief executive
recruiter donald clark does note an increase in searches for minority candidates	recruiter donald clark did note an increase in searches for minority candidates
explains a sotheby 's spokeswoman the statement means exactly what it says	explained a sotheby 's spokeswoman the statement meant exactly what it said
i think it 's more an issue of style	i thought it was more an issue of style
columbia savings is a major holder of so-called junk bonds	columbia savings was a major holder of so-called junk bonds
warehouse productivity is really beginning to take off	warehouse productivity was really beginning to take off
but british analysts are beginning to link the issues	but british analysts were beginning to link the issues
it is a certainty that mr. barre 's days are numbered	it was a certainty that mr. barre 's days were numbered
the minimum unit is 100,000	the minimum unit was 100,000
everything that mr. lantos says in his letter is partially true	everything that mr. lantos said in his letter was partially true
big withdrawals from the junk funds have continued this month	big withdrawals from the junk funds had continued this month
some economists expect further declines in investment spending	some economists expected further declines in investment spending
short selling is n't necessarily bad for the overall market	short selling was n't necessarily bad for the overall market
among her otc picks are oshkosh b'gosh and a&w brands	among her otc picks were oshkosh b'gosh and a&w brands
underwriters insist these issues are constructed to withstand extremely tough economic conditions	underwriters insisted these issues were constructed to withstand extremely tough economic conditions
estimated and actual results involving losses are omitted	estimated and actual results involving losses were omitted
the complexities of the insurance problem make the outcome difficult to predict	the complexities of the insurance problem made the outcome difficult to predict
the project known as lotus mansion has been mired in controversy	the project knew as lotus mansion had been mired in controversy
if he calls you up just tell him everything is fine	if he called you up just told him everything was fine
here are details of yesterday 's three-month and six-month bill auction	here were details of yesterday 's three-month and six-month bill auction
mr. smith is trying hard to allay the anger	mr. smith was trying hard to allay the anger
your story is an insult to the citizens of the mississippi delta	your story was an insult to the citizens of the mississippi delta
the project has already acquired a certain new york cachet	the project had already acquired a certain new york cachet
but many of these stocks have now become expensive	but many of these stocks had now become expensive
fast-food franchisers have managed to squeeze in stores into every corner available	fast-food franchisers had managed to squeeze in stores into every corner available
many investors have nagging worries however	many investors had nagging worries however
mccormick is a developer and manager of futures-investment limited partnerships	mccormick was a developer and manager of futures-investment limited partnerships
but east germany is merely the land of truly existing socialism	but east germany was merely the land of truly existing socialism
3 develop rental agreements with exclusive purchase options for the renter	3 developped rental agreements with exclusive purchase options for the renter
the channel reaches 6.5 million homes a penney spokesman said	the channel reached 6.5 million homes a penney spokesman said
security at a typical haagen inner-city center is impressive but unobtrusive	security at a typical haagen inner-city center was impressive but unobtrusive
you are a dinosaur a hangover in a 10 suit	you were a dinosaur a hangover in a 10 suit
labor problems top the list	labor problems topped the list
this says ms. peterson is what it 's all about	this said ms. peterson was what it was all about
i do n't think the market is going through another october '87	i did n't think the market was going through another october '87
it 's turning out to be a real blockbuster mr. sweig said	it was turning out to be a real blockbuster mr. sweig said
now it 's getting downright dangerous	now it was getting downright dangerous
the refund is about 9 million	the refund was about 9 million
the companies hope for a final agreement by year-end	the companies hoped for a final agreement by year-end
mr. holt is a columnist for the literary review in london	mr. holt was a columnist for the literary review in london
this is how american women won the right to vote	this was how american women won the right to vote
thanks to modern medicine more couples are growing old together	thanks to modern medicine more couples were growing old together
the report is n't generally available until late on tuesdays	the report was n't generally available until late on tuesdays
since then deliveries have slumped	since then deliveries had slumped
if he is competent and conscientious he serves us well	if he was competent and conscientious he served us well
giants fans went into euphoria says mr. engelken	giants fans went into euphoria said mr. engelken
computer companies commodity cyclical stocks like autos and retailing stocks he says	computer companies commodity cyclical stocks like autos and retailing stocks he said
they estimate the value of the transaction at close to 100 million	they estimated the value of the transaction at close to 100 million
ashland expects that sale to be complete next year	ashland expected that sale to be complete next year
but ms. mccraw says the magazine is fighting back	but ms. mccraw said the magazine was fighting back
nearby six dolphins will frolic in a 1.5 million-gallon saltwater aquarium	nearby six dolphins frolicced in a 1.5 million-gallon saltwater aquarium
the highway system is screwed up by the earthquake mr. engelken said	the highway system was screwed up by the earthquake mr. engelken said
rather they tend to have a set of two or three favorites	rather they tended to have a set of two or three favorites
the soreness he admits went away about a week after the shot	the soreness he admitted went away about a week after the shot
mr. shaffer takes primary responsibility for the electronic and technical-services group	mr. shaffer took primary responsibility for the electronic and technical-services group
long-term bonds have performed erratically this year	long-term bonds had performed erratically this year
the transaction represents lynch 's entry into the telephone business	the transaction represented lynch 's entry into the telephone business
now it offers richer commissions to lure a broker a week	now it offered richer commissions to lure a broker a week
students shun burger flipping for jobs tied to careers	students shunned burger flipping for jobs tied to careers
all the figures are adjusted for seasonal variations	all the figures were adjusted for seasonal variations
the notes are zero-coupon securities and will not pay interest periodically	the notes were zero-coupon securities and will not pay interest periodically
made of sand it receives around-the-clock maintainence against the battering waves	made of sand it received around-the-clock maintainence against the battering waves
norman j. harrison chairman will succeed him as chief executive	norman j. harrison chairman succeeded him as chief executive
details of credit enhancements vary widely from issue to issue	details of credit enhancements varyed widely from issue to issue
presumably ual is now trading closer to its value based on earnings	presumably ual was now trading closer to its value based on earnings
there is no rational justification for such behavior	there was no rational justification for such behavior
the group consists of weslock corp. and jpi modern inc	the group consisted of weslock corp. and jpi modern inc
ge capital has a working relationship with l.j. hooker	ge capital had a working relationship with l.j. hooker
the chair is a way to package massage	the chair was a way to package massage
figgie is a fire protection electronics and industrial products concern	figgie was a fire protection electronics and industrial products concern
i felt kind of safe she says	i felt kind of safe she said
golf has become the latest diversion for travelers stuck at some airports	golf had become the latest diversion for travelers stuck at some airports
that 's the highest estimate for a single collection in auction history	that was the highest estimate for a single collection in auction history
there are no price wars no competition	there were no price wars no competition
for now defense attorneys are tight-lipped about their plans	for now defense attorneys were tight-lipped about their plans
sierra tucson operates an addiction treatment center	sierra tucson operated an addiction treatment center
but the firm has never had a day like yesterday	but the firm had never had a day like yesterday
neatness does count at least in the grocery store	neatness did count at least in the grocery store
their effort has received a lukewarm response from the justice department	their effort had received a lukewarm response from the justice department
mr. melloan is deputy editor of the journal	mr. melloan was deputy editor of the journal
american cyanamid is a wayne n.j. chemicals drugs and fertilizer concern	american cyanamid was a wayne n.j. chemicals drugs and fertilizer concern
the government is projecting a 14 billion surplus for the fiscal year	the government was projecting a 14 billion surplus for the fiscal year
both issues are dated oct. 26	both issues were dated oct. 26
the henderson plant will continue its other chemical operations the company said	the henderson plant continued its other chemical operations the company said
his hands sit farther apart on the keyboard	his hands sat farther apart on the keyboard
the dispute shows clearly the global power of japan 's financial titans	the dispute showed clearly the global power of japan 's financial titans
he adds this is n't 1987 revisited	he added this was n't 1987 revisitted
drugs continue to be sold openly around schools parks and housing projects	drugs continued to be sold openly around schools parks and housing projects
it 's unlikely extracting the gas will cause subsidence says a spokeswoman	it was unlikely extracting the gas caused subsidence said a spokeswoman
jim beam print ads however strike different chords in different countries	jim beam print ads however struck different chords in different countries
what tongue to speak is an emotional mine field in the philippines	what tongue to speak was an emotional mine field in the philippines
it is merely the most obvious	it was merely the most obvious
some of these ideas are again under consideration in congress	some of these ideas were again under consideration in congress
only 36 of 1,200 priority cleanup sites have been decontaminated	only 36 of 1,200 priority cleanup sites had been decontaminated
the failure to obtain financing does n't by itself constitute a breach	the failure to obtain financing did n't by itself constitute a breach
even drexel is pulling back	even drexel was pulling back
though modest the change reaches beyond the oil patch too	though modest the change reached beyond the oil patch too
but there is a grimly ironic twist to the columbia loss	but there was a grimly ironic twist to the columbia loss
the parent also publishes weeklies shopping guides and specialty magazines	the parent also published weeklies shopping guides and specialty magazines
william coors is their uncle	william coors was their uncle
since march exports have been virtually flat	since march exports had been virtually flat
roughly a third of the charities reviewed flunk the test	roughly a third of the charities reviewed flunked the test
this market teaches us to be humble	this market taught us to be humble
the highest-yielding funds are still above 9 %	the highest-yielding funds were still above 9 %
european drama has had better though still mixed fortunes	european drama had had better though still mixed fortunes
the company also has a stock-repurchase plan	the company also had a stock-repurchase plan
all are expected to reopen soon	all were expected to reopen soon
why had mr. korotich been called	why had mr. korotich bed called
will ogonyok begin a series of reports analyzing the failures of perestroika	will ogonyok began a series of reports analyzing the failures of perestroika
we believe that the vast majority of imported material is safe	we believed that the vast majority of imported material was safe
technology stocks says mr. goldman	technology stocks said mr. goldman
the computers use the company 's own microprocessor called sparc sun said	the computers used the company 's own microprocessor called sparc sun said
some wall street firms monitor for recordkeeping purposes	some wall street firms monitored for recordkeeping purposes
another big question hovering over the debate is what president bush thinks	another big question hovering over the debate was what president bush thought
it 's a kind of an investment	it was a kind of an investment
it comes up with a toned-down version of a democratic proposal	it came up with a toned-down version of a democratic proposal
if mr. dozen has a weakness it may be his golf game	if mr. dozen had a weakness it may be his golf game
that 's going to cost ibm revenue	that was going to cost ibm revenue
the percentage change is since year-end	the percentage change was since year-end
lucy of course is pretty and smart though uneducated	lucy of course was pretty and smart though uneducated
most important hospital admission rates are stabilizing after several years of decline	most important hospital admission rates were stabilizing after several years of decline
in a way that 's what this is mr. gonzalez concedes	in a way that was what this was mr. gonzalez conceded
august is a month when people are paying school tuition he said	august was a month when people were paying school tuition he said
being a student-athlete at college is a lot different from high school	being a student-athlete at college was a lot different from high school
no doubt he believes the place can be salvaged	no doubt he believed the place could be salvaged
already the 1982 legislation has saved an estimated 800 million	already the 1982 legislation had saved an estimated 800 million
but out on cobb parkway ted negas sees it differently	but out on cobb parkway ted negas saw it differently
utilities management is a major commercial niche	utilities management was a major commercial niche
figures do n't include taxes or transaction costs	figures did n't include taxes or transaction costs
pemex which produces 40 % of government revenue desperately needs new investment	pemex which produced 40 % of government revenue desperately needs new investment
oil has long been mr. corry 's pet	oil had long been mr. corry 's pet
the comic strip has a magical everlasting quality about it	the comic strip had a magical everlasting quality about it
he is ogling the curtains rippling above the ventilation ducts	he was ogling the curtains rippling above the ventilation ducts
texans get reasonable car rental insurance	texans got reasonable car rental insurance
entertainment shows tend to cost twice that	entertainment shows tended to cost twice that
it does prolong the pain somewhat	it did prolong the pain somewhat
nothing bravura no arpeggios no ticklish fingering problems challenge the performer	nothing bravura no arpeggios no ticklish fingering problems challenged the performer
nothing has changed fundamentally in the tokyo market	nothing had changed fundamentally in the tokyo market
osborn also operates muzak franchises entertainment properties and small cable-television systems	osborn also operated muzak franchises entertainment properties and small cable-television systems
that 's where the two scripts would diverge	that was where the two scripts would diverge
what accounts for the difference	what accounted for the difference
consolidation has been long overdue	consolidation had been long overdue
it is scheduled for delivery in late 1991	it was scheduled for delivery in late 1991
since 1987 40 states have increased the speed limit on rural interstates	since 1987 40 states had increased the speed limit on rural interstates
a hearing is scheduled on the issue today	a hearing was scheduled on the issue today
the aspect of being a mega-lawyer is n't as important	the aspect of being a mega-lawyer was n't as important
it made our new year says mr. quinlan	it made our new year said mr. quinlan
both companies are conservative marketers that rely on extensive market research	both companies were conservative marketers that relyed on extensive market research
but it is n't clear why that should be so	but it was n't clear why that should be so
other democrats who favor a capital-gains cut are even more pessimistic	other democrats who favored a capital-gains cut were even more pessimistic
siemens is west germany 's largest electronics group	siemens was west germany 's largest electronics group
urban is the company 's first telephone subsidiary in wisconsin	urban was the company 's first telephone subsidiary in wisconsin
thereafter the rate will be renegotiated	thereafter the rate bed renegotiated
the figures occasionally include incomplete transactions in restricted stock	the figures occasionally included incomplete transactions in restricted stock
it 's expected to produce about 62,000 barrels per day	it was expected to produce about 62,000 barrels per day
but critics consider the changes regressive	but critics considered the changes regressive
that would be a normal bear market he says	that would be a normal bear market he said
city federal operates 105 banking offices in new jersey and florida	city federal operated 105 banking offices in new jersey and florida
goldman sachs & co. will manage the offering	goldman sachs & co. managed the offering
thus he asserts lloyd 's ca n't react quickly to competition	thus he asserted lloyd 's ca n't react quickly to competition
officials also say a national electricity shortage might not be far off	officials also said a national electricity shortage might not be far off
and most of these are absolutely unnecessary	and most of these were absolutely unnecessary
i have plenty more at home	i had plenty more at home
interest will be paid semi-annually	interest bed paid semi-annually
but a few funds have taken other defensive steps	but a few funds had taken other defensive steps
now it 's mr. icahn 's move	now it was mr. icahn 's move
ashurst is new to the far east	ashurst was new to the far east
they market cable-tv on the very grazing opportunities cnn seeks to discourage	they marketted cable-tv on the very grazing opportunities cnn seeked to discourage
we do n't disclose specifics	we did n't disclose specifics
mr. jones is attacking the problem on several fronts	mr. jones was attacking the problem on several fronts
but with some clients the talk can heat up a bit	but with some clients the talk could heat up a bit
gsx is a unit of laidlaw transportation ltd. of burlington canada	gsx was a unit of laidlaw transportation ltd. of burlington canada
by and large these efforts have borne fruit	by and large these efforts had borne fruit
but he thinks investors may be overreacting to the market 's problems	but he thought investors may be overreacting to the market 's problems
liberty national a bank holding company has assets exceeding 3 billion	liberty national a bank holding company had assets exceeding 3 billion
you do n't make any real money	you did n't make any real money
they will be the next hot magazines	they bed the next hot magazines
individuals can always have their hands slapped	individuals could always have their hands slapped
perhaps in time the supreme court will correct them	perhaps in time the supreme court corrected them
you 're making a pure bet on the market	you were making a pure bet on the market
the 40-a-share proposal values the company at about 106.6 million	the 40-a-share proposal valued the company at about 106.6 million
i do n't feel very ferocious	i did n't feel very ferocious
examples are ford looking at jaguar bellsouth looking at lin broadcasting	examples were ford looking at jaguar bellsouth looking at lin broadcasting
he has n't been able to replace the m'bow cabal	he had n't been able to replace the m'bow cabal
either one likes it or one does n't	either one liked it or one did n't
for vietnamese these are tricky often treacherous times	for vietnamese these were tricky often treacherous times
the notes are rated mig-1 by moody 's and sp1-plus by s&p	the notes were ratted mig-1 by moody 's and sp1-plus by s&p
housing and urban development 's budget is 17 billion	housing and urban development 's budget was 17 billion
where had all the money come from	where had all the money came from
mr. bullock says 45 % of revenues are tied to construction	mr. bullock said 45 % of revenues were tied to construction
the bank is a subsidiary of baltimore-based mnc financial inc	the bank was a subsidiary of baltimore-based mnc financial inc
seats are currently quoted at 425,000 bid and 475,000 offered	seats were currently quoted at 425,000 bid and 475,000 offered
it 's evident we 're entering a more competitive era he says	it was evident we were entering a more competitive era he said
the consequences of building empires with sand are showing up	the consequences of building empires with sand were showing up
and what they have shown is n't impressive	and what they had shown was n't impressive
they will be available in minimum denominations of 10,000	they bed available in minimum denominations of 10,000
it really brings you down to a human level she says	it really brought you down to a human level she said
justice is attempting to avoid a replay of these tactics	justice was attempting to avoid a replay of these tactics
over the long run however sleazy cases will make bad law	over the long run however sleazy cases made bad law
a unified europe poses labor problems and prospects for u.s. firms	a unified europe posed labor problems and prospects for u.s. firms
and some oil companies are trying to lock in future supplies	and some oil companies were trying to lock in future supplies
a big reason for the chemical price retreat is overexpansion	a big reason for the chemical price retreat was overexpansion
it needs to sort itself out	it needed to sort itself out
their problem is one of inefficiency of an industrial economy	their problem was one of inefficiency of an industrial economy
motorola is in good company	motorola was in good company
other as yet unnamed cities will follow	other as yet unnamed cities followed
now as in those two years her stock market indicators are positive	now as in those two years her stock market indicators were positive
the security business is my favorite subject	the security business was my favorite subject
i can do five things at once to be a businessman	i could do five things at once to be a businessman
this is not nearly good enough	this was not nearly good enough
the democratic appointee has n't been determined the official said	the democratic appointee had n't been determined the official said
so many californians believe they can get by without it	so many californians believed they could get by without it
other fundamental reforms of the 1986 act have been threatened as well	other fundamental reforms of the 1986 act had been threatened as well
the pressure for change will rise with costs	the pressure for change rose with costs
the resulting stockpiling has depressed the market	the resulting stockpiling had depressed the market
they are growing more pragmatic about their role	they were growing more pragmatic about their role
testimony is expected to continue until early december	testimony was expected to continue until early december
the offering is scheduled to expire on nov. 30	the offering was scheduled to expire on nov. 30
the suit seeks in excess of 350,000 in damages	the suit seeked in excess of 350,000 in damages
he bites it scowls and throws it down	he bit it scowls and throws it down
the issue will be sold through morgan stanley & co	the issue bed sold through morgan stanley & co
it reduces the baseline by 169 billion	it reduced the baseline by 169 billion
i 'm probably not going to vote for any capital-gains proposal	i was probably not going to vote for any capital-gains proposal
for them it makes all kinds of sense	for them it made all kinds of sense
it is fun competing as a private company mr. brawer says	it was fun competing as a private company mr. brawer said
the company deliberately understaffs stretching employees ' schedules to the limit	the company deliberately understaffsed stretching employees ' schedules to the limit
stewart & stevenson makes equipment powered with diesel and gas turbines	stewart & stevenson made equipment powered with diesel and gas turbines
welcome to the 28th tokyo motor show	welcomed to the 28th tokyo motor show
miss shlaes is editorial features editor of the wall street journal\/europe	miss shlaes was editorial features editor of the wall street journal\/europe
who will take over these places	who took over these places
developers are also eyeing the real estate portfolios of major corporations	developers were also eyeing the real estate portfolios of major corporations
really now did she have to ask	really now did she had to ask
now because of various difficulties the product has been scrapped	now because of various difficulties the product had been scrapped
on a stand-alone basis the network ought to make money he says	on a stand-alone basis the network ought to make money he said
this will raise the energy level of the show	this raised the energy level of the show
revenue is estimated at 18.6 million	revenue was estimated at 18.6 million
we tell them all the major companies are having financial difficulties	we told them all the major companies were having financial difficulties
you can tell they 've got nothin	you could tell they 've got nothin
the bills are dated oct. 31 and mature dec. 21 1989	the bills were dated oct. 31 and mature dec. 21 1989
further staff cuts are likely the spokesman indicated	further staff cuts were likely the spokesman indicated
now there 's an idea	now there was an idea
it shows a boy hurling rocks at a street lamp	it showed a boy hurling rocks at a street lamp
jeffrey peter and joseph jr. are brothers	jeffrey peter and joseph jr. were brothers
however stateswest is n't abandoning its pursuit of the much-larger mesa	however stateswest was n't abandoning its pursuit of the much-larger mesa
but the shift has also been fueled by necessity	but the shift had also been fueled by necessity
one such company is bankers trust co	one such company was bankers trust co
the portfolio currently includes 95 million in receivables ge capital said	the portfolio currently included 95 million in receivables ge capital said
a serious economic downturn pessimists observe could hurt the expansionists	a serious economic downturn pessimists observed could hurt the expansionists
continental airlines is a unit of texas air corp. houston	continental airlines was a unit of texas air corp. houston
ibm is based in armonk n.y	ibm was based in armonk n.y
and the number of rigs active in the u.s. is inching up	and the number of rigs active in the u.s. was inching up
the uncertainty is sending shivers through brazilian financial markets	the uncertainty was sending shivers through brazilian financial markets
my language sure goes to pot down here on the coast	my language sure went to pot down here on the coast
food tobacco drugs and utilities are the classic examples	food tobacco drugs and utilities were the classic examples
bsb has 3.1 million shares outstanding	bsb had 3.1 million shares outstanding
the companies being acquired provide telecommunications services to the telephone industry	the companies being acquired provided telecommunications services to the telephone industry
the final maturity is in five years	the final maturity was in five years
every time he sees me he gets very nervous	every time he saw me he got very nervous
my position is one founded on both the facts and the law	my position was one founded on both the facts and the law
these figures are n't seasonally adjusted	these figures were n't seasonally adjusted
mr. zupan teaches at the university of southern california 's business school	mr. zupan taught at the university of southern california 's business school
will the investments pay off	will the investments paid off
it 's a horrible machine actually	it was a horrible machine actually
the two companies each produce market pulp containerboard and white paper	the two companies each produced market pulp containerboard and white paper
the title of chief executive officer is n't used	the title of chief executive officer was n't used
but do n't do anything rash	but did n't do anything rash
labor problems are the last thing mr. smith needs right now	labor problems were the last thing mr. smith needed right now
japanese firms push posh car showrooms	japanese firms pushed posh car showrooms
the remainder of the house leans precariously against a sturdy oak tree	the remainder of the house leaned precariously against a sturdy oak tree
accepted theories state that investors require higher returns on riskier investments	accepted theories stated that investors required higher returns on riskier investments
the fundamentals do n't change in an hour he says	the fundamentals did n't change in an hour he said
one handout promises pedigrees parties post times parimutuels and pageantry	one handout promised pedigrees parties post times parimutuels and pageantry
but daewoo is expanding too	but daewoo was expanding too
not all of nasa 's space-science work will be so auspicious though	not all of nasa 's space-science work bed so auspicious though
palmtops are n't far behind	palmtops were n't far behind
scientists call the new class of genes tumor-suppressors or simply anti-cancer genes	scientists called the new class of genes tumor-suppressors or simply anti-cancer genes
the company is a mexico mo. maker of refractory products	the company was a mexico mo. maker of refractory products
a lot of donors just get taken	a lot of donors just got taken
the percentage change is since year-end	the percentage change was since year-end
mr. roberts also takes a swipe at the bank 's adjustment lending	mr. roberts also took a swipe at the bank 's adjustment lending
after a while someone has to go over the side	after a while someone had to go over the side
size and weight considerations also have limited screen displays	size and weight considerations also had limited screen displays
a thin man in a gray suit looks up from a newspaper	a thin man in a gray suit looked up from a newspaper
mccaw 's bid also has a similar clause	mccaw 's bid also had a similar clause
this seems to be the season for revivals in chicago	this seemed to be the season for revivals in chicago
it has a similar project for 200,000 cars a year	it had a similar project for 200,000 cars a year
crime is clearly more deadly to small-scale entrepreneurship than to big businesses	crime was clearly more deadly to small-scale entrepreneurship than to big businesses
state government is more typically split along republican-governor\/democratic-legislature lines than the reverse	state government was more typically split along republican-governor\/democratic-legislature lines than the reverse
lawmakers in both houses support the higher level	lawmakers in both houses supported the higher level
estimated and actual results involving losses are omitted	estimated and actual results involving losses were omitted
the markets are returning to normalcy	the markets were returning to normalcy
for there is an emerging protocol indeed an etiquette to it	for there was an emerging protocol indeed an etiquette to it
the models which cost about 75,000 each will be used in research	the models which cost about 75,000 each bed used in research
banks want to remain competitive said norberto mehl chairman of banxquote	banks wanted to remain competitive said norberto mehl chairman of banxquote
not everything looks grim for quantum	not everything looked grim for quantum
in the end i think david will be judged for being david	in the end i thought david bed judged for being david
you hate to do it because he 's your father	you hated to do it because he was your father
we will probably have a year-end rally and then go down again	we had a year-end rally and then go down again probably
he 's totally geared to a punitive position	he was totally geared to a punitive position
these people have different agendas	these people had different agendas
it is a quick fix for a complex problem	it was a quick fix for a complex problem
a final ratings tally from a.c. nielsen co. is due today	a final ratings tally from a.c. nielsen co. was due today
the government insists that such a possibility is low	the government insisted that such a possibility was low
we think that the ratings revision is unfortunate but not unexpected	we thought that the ratings revision was unfortunate but not unexpected
these products are the heart of our transmission-product line mr. buchner said	these products were the heart of our transmission-product line mr. buchner said
few petitions however have actually delayed or scuttled mergers	few petitions however had actually delayed or scuttled mergers
lakeland holders will have the option to request either stock or cash	lakeland holders had the option to request either stock or cash
reagan era young hold liberal views	reagan era young held liberal views
up until now most stores have followed the same basic overseas strategy	up until now most stores had followed the same basic overseas strategy
mr. rey says the move is yet another example of his conservatism	mr. rey said the move was yet another example of his conservatism
senator pete domenici calls this effort the first gift of democracy	senator pete domenici called this effort the first gift of democracy
we are all very amiable mr. brawer says	we were all very amiable mr. brawer said
profit systems valley stream n.y. is an air freight forwarding concern	profit systems valley stream n.y. was an air freight forwarding concern
the trend has prompted beijing to intensify efforts to curb imports	the trend had prompted beijing to intensify efforts to curb imports
ibm already participates in one industrywide effort to improve semiconductor-manufacturing techniques	ibm already participated in one industrywide effort to improve semiconductor-manufacturing techniques
revenue for fiscal 1989 is expected to exceed 124 million	revenue for fiscal 1989 was expected to exceed 124 million
in other words they treat you like a piece of meat	in other words they treated you like a piece of meat
mr. kilpatrick will remain a director	mr. kilpatrick remained a director
more than 700 people work in the gte building	more than 700 people worked in the gte building
chairman antonio asensio will retain a 70 % share in zeta	chairman antonio asensio retained a 70 % share in zeta
the board has 10 business days to respond	the board had 10 business days to respond
now she says it 's no longer an issue	now she said it was no longer an issue
some smaller clients do n't seem to notice his switch	some smaller clients did n't seem to notice his switch
kia is reportedly also considering such a plan	kia was reportedly also considering such a plan
we think alliances are very important mr. eddington says	we thought alliances were very important mr. eddington said
recent data from new york city provide more of the picture	recent data from new york city provided more of the picture
at the same time it has been caught in an earnings squeeze	at the same time it had been caught in an earnings squeeze
algeria plans to increase natural-gas sales to europe and the u.s.	algeria planned to increase natural-gas sales to europe and the u.s.
their ridicule of him is no substitute for argument	their ridicule of him was no substitute for argument
it 's very worrying that these markets ca n't cope	it was very worrying that these markets ca n't cope
brokerage houses are sweet on h&r block too	brokerage houses were sweet on h&r block too
and that naturally exacerbates price movements	and that naturally exacerbated price movements
bonds due 2003 2004 and 2015 are n't being formally reoffered	bonds due 2003 2004 and 2015 were n't being formally reoffered
conservatives now hold only a 5-4 edge	conservatives now held only a 5-4 edge
my style is less informal mr. brawer says	my style was less informal mr. brawer said
health care property holds an interest in 139 facilities in 30 states	health care property held an interest in 139 facilities in 30 states
but they have n't yet drawn the operational policy conclusions	but they had n't yet drawn the operational policy conclusions
crested butte population 1,200 is a bastion of the sport	crested butte population 1,200 was a bastion of the sport
the company expects to resume full operations by today	the company expected to resume full operations by today
institutions that usually buy retail paper have to be more concerned	institutions that usually buy retail paper had to be more concerned
they root among the designer offerings at neiman-marcus and bullocks wilshire	they rooted among the designer offerings at neiman-marcus and bullocks wilshire
both moves are effective today	both moves were effective today
there has been a tremendous increase in mmi positions mr. selkin said	there had been a tremendous increase in mmi positions mr. selkin said
battelle 's mr. mccall thinks steelmakers should concentrate more on construction	battelle 's mr. mccall thought steelmakers should concentrate more on construction
it has won about 15 % of the retail pc market	it had won about 15 % of the retail pc market
the appointments are part of a planned succession at the company	the appointments were part of a planned succession at the company
her sister cynthia wishes toni had a different job	her sister cynthia wished toni had a different job
yet they do n't disparage their audiences by disparaging their act	yet they did n't disparage their audiences by disparaging their act
he would agrees the chairman	he would agreed the chairman
i 'm encouraged by the action	i was encouraged by the action
officially the statement is n't an attack on the rafale	officially the statement was n't an attack on the rafale
he still has 1,143 shares according to sec files	he still had 1,143 shares according to sec files
until now most japanese charges have been responses to suits against them	until now most japanese charges had been responses to suits against them
h&r block is one of the great success stories of u.s. business	h&r block was one of the great success stories of u.s. business
some bankers are reporting more inquiries than usual about cds since friday	some bankers were reporting more inquiries than usual about cds since friday
mason serves commercial and government customers including the national institutes of health	mason served commercial and government customers including the national institutes of health
there are n't too many winners	there were n't too many winners
the pain is too great	the pain was too great
making computers smaller often means sacrificing memory	making computers smaller often meant sacrificing memory
the branches are just warmed over empty halls says mr. konheim	the branches were just warmed over empty halls said mr. konheim
essentially the critics of stock-index futures fall into two camps	essentially the critics of stock-index futures fell into two camps
gillette south africa employs about 250 people	gillette south africa employed about 250 people
officials expect difficulty routing traffic through downtown san francisco	officials expected difficulty routing traffic through downtown san francisco
weatherford currently has approximately 11.1 million common shares outstanding	weatherford currently had approximately 11.1 million common shares outstanding
the animal-rights movement has n't helped sales	the animal-rights movement had n't helped sales
think i 'll buy one of those i survived t-shirts after all	thought i 'll buy one of those i survived t-shirts after all
i do n't think that is the case	i did n't think that was the case
drexel is owed 20 million by the partnership	drexel was owed 20 million by the partnership
top officers insist maidenform 's greatest strength is its family ownership	top officers insisted maidenform 's greatest strength was its family ownership
total merchant banking exposures are in excess of the firm 's equity	total merchant banking exposures were in excess of the firm 's equity
am stereo remains largely undeveloped because it lacks a uniform delivery system	am stereo remained largely undeveloped because it lacked a uniform delivery system
already congress is toying with legislation to curb the fed 's independence	already congress was toying with legislation to curb the fed 's independence
but analysts estimate their trading profit at 30 million	but analysts estimated their trading profit at 30 million
mr. bloch concedes that a recent diversification attempt fell through	mr. bloch conceded that a recent diversification attempt fell through
social security and spending for poor people are exempted	social security and spending for poor people were exempted
smaller projects swell the figure to at least 2.5 billion	smaller projects swelled the figure to at least 2.5 billion
they gleefully await the dream season in 1990	they gleefully awaited the dream season in 1990
conservatives have an important decision to make this fall	conservatives had an important decision to make this fall
not a peso is offered	not a peso was offered
one of their pastors has envisioned a new utopia of creative socialism	one of their pastors had envisioned a new utopia of creative socialism
compaq is already taking aim at zenith 's market share	compaq was already taking aim at zenith 's market share
it 's no secret that block dominates the mass-market tax-preparation business	it was no secret that block dominated the mass-market tax-preparation business
mr. strieber knows a lot about aliens	mr. strieber knew a lot about aliens
this has n't been kellogg co. 's year	this had n't been kellogg co. 's year
estimated and actual results involving losses are omitted	estimated and actual results involving losses were omitted
cbs news sends scripts to agents who pass them along to clients	cbs news sent scripts to agents who passed them along to clients
it has some of the highest costs in the league	it had some of the highest costs in the league
you can too if you like me refuse to bite the bullet	you could too if you like me refuse to bite the bullet
coach them in handling complaints so that they can resolve problems immediately	coached them in handling complaints so that they could resolve problems immediately
proceeds will be used to eliminate and restructure bank debt	proceeds bed used to eliminate and restructure bank debt
two steps are necessary to translate this idea into action	two steps were necessary to translate this idea into action
you can shift out of reality with black and white he adds	you could shift out of reality with black and white he added
so what does george bush really believe	so what does george bush really believed
some analysts speculate the weakening stock may yet attract a suitor	some analysts speculated the weakening stock may yet attract a suitor
the japanese take the long view said mr. veronis	the japanese took the long view said mr. veronis
the junk-mail titans ever optimistic are looking for ways around the problem	the junk-mail titans ever optimistic were looking for ways around the problem
you certainly can say it 's going to be extremely severe	you certainly could say it 's going to be extremely severe
sometimes like now it 's gray	sometimes like now it was gray
that 's chandler 's setup	that was chandler 's setup
intensive audits are coming to 55,500 taxpayers as research guinea pigs	intensive audits were coming to 55,500 taxpayers as research guinea pigs
opinion is mixed over its three-month prospects	opinion was mixed over its three-month prospects
what we want to do is take a more aggressive stance	what we wanted to do was take a more aggressive stance
that puts pressure on cd rates	that put pressure on cd rates
high-end u.s. furriers say these imports have n't squeezed them	high-end u.s. furriers said these imports had n't squeezed them
dr. lourie says the justice department interviewed him last july	dr. lourie said the justice department interviewed him last july
no one panicked a spokeswoman says	no one panicked a spokeswoman said
do n't forget trout have very soft mouths	did n't forget trout had very soft mouths
having donated heavily to museums they demand a place on their boards	having donated heavily to museums they demanded a place on their boards
hotel expansion and an influx of more-discriminating tourists have hurt motels	hotel expansion and an influx of more-discriminating tourists had hurt motels
lead underwriter to the issue is toronto dominion securities inc	lead underwriter to the issue was toronto dominion securities inc
and her husband sometimes calls her ducky	and her husband sometimes called her ducky
i have accomplished too much	i had accomplished too much
and they say the outlook for 1990 is nearly as bad	and they said the outlook for 1990 was nearly as bad
nausea and vomiting are other common side effects	nausea and vomiting were other common side effects
dragging prop. 13 into this story is a pretty long stretch	dragging prop. 13 into this story was a pretty long stretch
increasing personal spending and capital investment are fueling growth the company said	increasing personal spending and capital investment were fueling growth the company said
it invests primarily in tax-exempt municipal securities	it invested primarily in tax-exempt municipal securities
i am sure they will be going for a full bid	i was sure they bed going for a full bid
some foodstuff shipments will probably resume thursday he said	some foodstuff shipments resumed thursday probably he said
industry executives are wishing mr. achenbaum well	industry executives were wishing mr. achenbaum well
however on balance the charity game helps america	however on balance the charity game helped america
that inquiry has n't resolved similar allegations involving another chemical options trader	that inquiry had n't resolved similar allegations involving another chemical options trader
as a result of the sales he holds 6,727,042 shares	as a result of the sales he held 6,727,042 shares
the fund invests heavily in dollar-denominated money-market securities overseas	the fund invested heavily in dollar-denominated money-market securities overseas
jailed african-american activist wins a battle against the	jailed african-american activist won a battle against the
the constraints do n't bother the office 's 54-year-old manager erich stromeyer	the constraints did n't bother the office 's 54-year-old manager erich stromeyer
environmental protection program current interest bonds are due 1995-1999 2005 and 2009	environmental protection program current interest bonds were due 1995-1999 2005 and 2009
in our formula we do n't have any losers except the competition	in our formula we did n't have any losers except the competition
many companies have set up machinery to assure workers a fair shake	many companies had set up machinery to assure workers a fair shake
rates for the wall street journal reports will remain unchanged	rates for the wall street journal reports remained unchanged
the action increases the annual dividend to 1.20 a share from 1.08	the action increased the annual dividend to 1.20 a share from 1.08
sir richard succeeds john plastow who resigned in july	sir richard succeeded john plastow who resigned in july
cra is 49%-owned by rtz corp. of britain	cra was 49%-owned by rtz corp. of britain
after that the federal share diminishes	after that the federal share diminished
do you think the british know something that we do n't	do you thought the british knew something that we did n't
our view is that we may see a profit decline	our view was that we may see a profit decline
it follows the same pattern as his tax returns	it followed the same pattern as his tax returns
more bothersome there are several apparent anachronisms	more bothersome there were several apparent anachronisms
leaseway provides transportation services for manufacturers distributors and retailers	leaseway provided transportation services for manufacturers distributors and retailers
i am aware we have real budgetary problems	i was aware we had real budgetary problems
they pay interest only for 115 months with principal payments beginning thereafter	they paid interest only for 115 months with principal payments beginning thereafter
but we will take it into consideration	but we took it into consideration
the minimum unit is 100,000	the minimum unit was 100,000
doman is based in duncan british columbia	doman was based in duncan british columbia
details of the escrow agreement have n't been completed the companies said	details of the escrow agreement had n't been completed the companies said
the reality is that bank finances are rock solid	the reality was that bank finances were rock solid
this deal is like a roach motel he said	this deal was like a roach motel he said
adds mr. eidsmo what felt good that day was done that day	added mr. eidsmo what felt good that day was done that day
she lives in oakland a community hit hard by the earthquake	she lived in oakland a community hit hard by the earthquake
and in financial markets irrational behavior is sometimes translated into catastrophe	and in financial markets irrational behavior was sometimes translated into catastrophe
he succeeds william kohut who resigned earlier this year	he succeeded william kohut who resigned earlier this year
other scandal survivors are sometimes the best source of solace	other scandal survivors were sometimes the best source of solace
two previous exorcisms have failed	two previous exorcisms had failed
the most recent sales do n't appear to be option-related he said	the most recent sales did n't appear to be option-related he said
still radio shack is aware that some of its products are controversial	still radio shack was aware that some of its products were controversial
switzerland 's most famous raider says he is n't one	switzerland 's most famous raider said he was n't one
but it does n't take too many lines to figure harry out	but it did n't take too many lines to figure harry out
his general-election campaign is almost reagan-like all muted pictures and comforting words	his general-election campaign was almost reagan-like all muted pictures and comforting words
farm income is 15 % below the average	farm income was 15 % below the average
the bank employs 8,000 people in spain and 2,000 abroad	the bank employed 8,000 people in spain and 2,000 abroad
for employee and employer alike the worry is widespread	for employee and employer alike the worry was widespread
but what do we mean specifically by creativity	but what do we meant specifically by creativity
things have grown worse since june 4 mr. lai says	things had grown worse since june 4 mr. lai said
we are not trying to encourage everyone	we were not trying to encourage everyone
that 's geologically correct but a trifle unfair otherwise	that was geologically correct but a trifle unfair otherwise
we will not be commenting beyond the news release the spokesman said	we did not be commenting beyond the news release the spokesman said
the company mr. renzas said has n't yet determined what to do	the company mr. renzas said had n't yet determined what to do
mr. rosen is also pushing retail sales	mr. rosen was also pushing retail sales
expect tricky stuff from pitchers says mr. weaver the manager	expected tricky stuff from pitchers said mr. weaver the manager
shearson does n't break out the earnings of its subsidiaries	shearson did n't break out the earnings of its subsidiaries
there 's no constitutional right involved in the rule change he says	there was no constitutional right involved in the rule change he said
i consider this a second career he said	i considered this a second career he said
we ca n't do without their help says mrs. conradie	we ca n't do without their help said mrs. conradie
more recently sotheby 's has predicted the collection will fetch 140 million	more recently sotheby 's had predicted the collection fetched 140 million
the red granite mausoleum draws thousands of visitors daily	the red granite mausoleum drew thousands of visitors daily
the old and revised numbers both include over-allotment provisions	the old and revised numbers both included over-allotment provisions
it 's good exercise he says	it was good exercise he said
here is how three vietnamese are coping with change	here was how three vietnamese were coping with change
intelogic holds 27.5 % of datapoint 's common shares outstanding	intelogic held 27.5 % of datapoint 's common shares outstanding
the incident occurred saturday night	the incident occured saturday night
the successful launch continues a remarkable recovery in the u.s. space-science program	the successful launch continued a remarkable recovery in the u.s. space-science program
in such an arrangement all benefit he said	in such an arrangement all benefitted he said
i will hereafter devote myself to serving him	i devoted myself to serving him hereafter
du pont as it happens has a potential substitute for cfcs	du pont as it happenned had a potential substitute for cfcs
but name-dropping has other benefits often civic	but name-dropping had other benefits often civic
call it the we 're too broke to fight defense	called it the we were too broke to fight defense
many affluent people place personal success and money above family	many affluent people placed personal success and money above family
still others are looking at overseas markets	still others were looking at overseas markets
a metric ton is equal to 2,204.62 pounds	a metric ton was equal to 2,204.62 pounds
there 's a casino the financial heart of it all	there was a casino the financial heart of it all
supporting banks will sign a texas declaration of independents	supporting banks signed a texas declaration of independents
if nobody buys i bring my prices down	if nobody bought i brought my prices down
he reset opening arguments for today	he resetted opening arguments for today
i 'm happy that he feels positively about our company he said	i was happy that he felt positively about our company he said
the hotel is scheduled to open in 1992	the hotel was scheduled to open in 1992
the company is active in office and residential development in new york	the company was active in office and residential development in new york
the painting is 10 feet wide seven feet high	the painting was 10 feet wide seven feet high
mr. schneider is cool to georgia pacific and abitibi-price	mr. schneider was cool to georgia pacific and abitibi-price
the campeau situation is a little uncertain and very difficult to analyze	the campeau situation was a little uncertain and very difficult to analyze
i look at it as a ho-hum matter he says	i looked at it as a ho-hum matter he said
but this time it 's hurting opposition as well as ruling-party members	but this time it was hurting opposition as well as ruling-party members
she thinks traders should buy the stock if it tumbles to 35	she thought traders should buy the stock if it tumbles to 35
starting tomorrow i 'm stalking you	starting tomorrow i was stalking you
here 's a look at some of the alternatives	here was a look at some of the alternatives
advertisers attribute this shared loyalty to the striking similarity among brands	advertisers attributed this shared loyalty to the striking similarity among brands
we have some level of financial interest in the collection	we had some level of financial interest in the collection
to date scientists have fingered two of these cancer-suppressors	to date scientists had fingered two of these cancer-suppressors
what market makers provide is immediacy a very valuable service	what market makers provided was immediacy a very valuable service
but fujitsu ltd. has taken that practice to a new extreme	but fujitsu ltd. had taken that practice to a new extreme
that 's just what joseph granville expects	that was just what joseph granville expected
these people are n't necessarily stupid or naive	these people were n't necessarily stupid or naive
still complete and total segregation remains elusive	still complete and total segregation remained elusive
now those routes are n't expected to begin until jan	now those routes were n't expected to begin until jan
in singapore per-capita consumption is about one-third that of the u.s.	in singapore per-capita consumption was about one-third that of the u.s.
the plant has a hairy stem that produces flowers and diminutive seeds	the plant had a hairy stem that produced flowers and diminutive seeds
the u.s.-japan security treaty can continue sort of	the u.s.-japan security treaty could continue sort of
soldiers and sailors are still measured in inches and pounds	soldiers and sailors were still measured in inches and pounds
the bonds are insured and rated triple-a by moody 's and s&p	the bonds were insured and rated triple-a by moody 's and s&p
some companies including heinz even pay part of the fee	some companies including heinz even paid part of the fee
only for yardwork and home maintenance did women do less than half	only for yardwork and home maintenance did women did less than half
tandem 's pricing is just as aggressive	tandem 's pricing was just as aggressive
among these crimes are murder on federal land presidential assassination and espionage	among these crimes were murder on federal land presidential assassination and espionage
it is widely expected that they will	it was widely expected that they did
note how the baseline program assumes a sharp increase in future appropriations	noted how the baseline program assumed a sharp increase in future appropriations
its developer is a polish american sasha muniak	its developer was a polish american sasha muniak
i 'm for the giants today but only because they lost yesterday	i was for the giants today but only because they lost yesterday
it 's hard to know if people are responding truthfully	it was hard to know if people were responding truthfully
brokers do n't deny that	brokers did n't deny that
mr. smith 39 retains the title of chief financial officer	mr. smith 39 retained the title of chief financial officer
i do n't know mr. phillips all that well	i did n't know mr. phillips all that well
employees have n't yet been notified	employees had n't yet been notified
these guys prey on human frailties	these guys preyed on human frailties
it now has the chance to redress that record in namibia	it now had the chance to redress that record in namibia
and they plan to buy more today	and they planned to buy more today
pressed on the matter he is more specific	pressed on the matter he was more specific
some diaries simply are n't worth snooping in	some diaries simply were n't worth snooping in
ellen cokely a tourist from alton ill. seems inclined to agree	ellen cokely a tourist from alton ill. seemed inclined to agree
nevertheless he says a depression does n't appear likely	nevertheless he said a depression did n't appear likely
not even all the brokerage firms see clear sailing ahead	not even all the brokerage firms saw clear sailing ahead
but observers expect broad support	but observers expected broad support
what really stirs his muse though is aerobic architecture	what really stirs his muse though was aerobic architecture
cfcs are widely used as solvents coolants and fire suppressants	cfcs were widely used as solvents coolants and fire suppressants
i think mr. phillips is going to need some help	i thought mr. phillips was going to need some help
all serial bonds are being offered at par except those due 2002	all serial bonds were being offered at par except those due 2002
still employees do occasionally try to smuggle out a gem or two	still employees did occasionally try to smuggle out a gem or two
in addition global petroleum demand has been climbing	in addition global petroleum demand had been climbing
that share has remained at about 24 % since 1970	that share had remained at about 24 % since 1970
here are four key steps	here were four key steps
deciding what constitutes terrorism can be a legalistic exercise	deciding what constituted terrorism could be a legalistic exercise
who knows how much they 'll be worth 100 years from now	who knew how much they 'll be worth 100 years from now
when it comes to money once bitten 2,000 times shy	when it came to money once bitten 2,000 times shy
it also licenses optically based data storage and retrieval devices	it also licensed optically based data storage and retrieval devices
that 's the only note that 's truly in tune	that was the only note that was truly in tune
but nevada state labor economists think a shortage is probable	but nevada state labor economists thought a shortage was probable
she declines to show them	she declined to show them
he 's a rare democratic hawk	he was a rare democratic hawk
more than 100,000 claims against robins are pending	more than 100,000 claims against robins were pending
goldman sachs 's mr. einhorn for one subscribes to that scenario	goldman sachs 's mr. einhorn for one subscribed to that scenario
the assembly plant is scheduled to resume production on oct. 30	the assembly plant was scheduled to resume production on oct. 30
it has more drug users than boston has people	it had more drug users than boston had people
in the newspapers on the radio and tv psyllium is everywhere	in the newspapers on the radio and tv psyllium was everywhere
that has outraged some fans	that had outraged some fans
the computer can process 13.3 million calculations called floating-point operations every second	the computer could process 13.3 million calculations called floating-point operations every second
over the next 50 years 500 billion is earmarked for the program	over the next 50 years 500 billion was earmarked for the program
the states have their own ideas about regulation and certification	the states had their own ideas about regulation and certification
in the short term the move is likely to have little effect	in the short term the move was likely to have little effect
we just want to have our own cup of tea	we just wanted to have our own cup of tea
there is a simple reason for this the cuban people	there was a simple reason for this the cuban people
in california this is the reality	in california this was the reality
so far mr. dassault has resisted pressure to change	so far mr. dassault had resisted pressure to change
k mart runs 2,200 k mart stores primarily in leased facilities	k mart ran 2,200 k mart stores primarily in leased facilities
irish and soviet people are similar says mr. ovcharenko	irish and soviet people were similar said mr. ovcharenko
but they attribute much of the weakness to customer inventory reductions	but they attributed much of the weakness to customer inventory reductions
moreover the process is n't without its headaches	moreover the process was n't without its headaches
cuban military personnel also have been active in afghanistan since 1979	cuban military personnel also had been active in afghanistan since 1979
how such remarks translate into policy wo n't become clear for months	how such remarks translated into policy wo n't become clear for months
seats are currently quoted at 430,000 bid and 525,000 asked	seats were currently quoted at 430,000 bidded and 525,000 asked
what i hope to bring to this is another word process	what i hoped to bring to this was another word process
the merger is subject to regulatory clearance and a definitive agreement	the merger was subject to regulatory clearance and a definitive agreement
but mr. zoeller also acknowledges that consultants can be very effective	but mr. zoeller also acknowledged that consultants could be very effective
silver 's history of volatility is also discouraging investors dealers say	silver 's history of volatility was also discouraging investors dealers said
they serve the industries and the special-interest groups	they served the industries and the special-interest groups
he says he has never even dined with gangsters	he said he had never even dined with gangsters
capital travels to europe as 1992 unification nears	capital traveled to europe as 1992 unification neared
galveston-houston makes and markets products for the construction mining and energy industries	galveston-houston made and markets products for the construction mining and energy industries
the jokes are n't just on the japanese though	the jokes were n't just on the japanese though
since tuesday the shares have gained nearly 4 %	since tuesday the shares had gained nearly 4 %
about 518 million of debt is affected	about 518 million of debt was affected
the second time he says they left the shovel	the second time he said they left the shovel
he says it accounts for 25 % of total sales	he said it accounted for 25 % of total sales
dalkon shield claimants hope to stop reorganization-plan appeal	dalkon shield claimants hoped to stop reorganization-plan appeal
each right entitles shareholders to buy one-half share of common for 30	each right entitled shareholders to buy one-half share of common for 30
it 's like fighting your way out of a fog	it was like fighting your way out of a fog
ms. renk says retailers nixed a promotion for pins with animal motifs	ms. renk said retailers nixed a promotion for pins with animal motifs
since 1979 the number of motel rooms has fallen by 17,000	since 1979 the number of motel rooms had fallen by 17,000
but the strategy is n't helping much this time	but the strategy was n't helping much this time
we do not depend on pharmaceutical companies for our support	we did not depend on pharmaceutical companies for our support
the most dramatic changes however probably will come in new-product development	the most dramatic changes however probably came in new-product development
about 130,000 vehicles cross during a 24-hour period	about 130,000 vehicles crossed during a 24-hour period
hooker is based in sydney australia	hooker was based in sydney australia
not everyone has jumped on the breeden bandwagon however	not everyone had jumped on the breeden bandwagon however
this is exactly the same thing as far as i 'm concerned	this was exactly the same thing as far as i was concerned
it was the plunge that did n't happen he says	it was the plunge that did n't happen he said
at least once an episode we see protestors marching around screaming slogans	at least once an episode we saw protestors marching around screaming slogans
quebecor will own 57.5 % of the new subsidiary	quebecor owned 57.5 % of the new subsidiary
reform starts in the pentagon	reform started in the pentagon
her son healthy and symptom-free currently takes no medication	her son healthy and symptom-free currently took no medication
analysts and competitors however doubt the numbers were that high	analysts and competitors however doubted the numbers were that high
their commitment to creativity can not survive adolescent illiteracy	their commitment to creativity could not survive adolescent illiteracy
he says blaming futures is like blaming the messenger	he said blaming futures was like blaming the messenger
is this what the home builders want	is this what the home builders wanted
and their suspicions of each other run deep	and their suspicions of each other ran deep
borrowers ' incentives are equally skewed	borrowers ' incentives were equally skewed
but such spots can be too soft	but such spots could be too soft
his humility gives him a much better chance of success	his humility gave him a much better chance of success
supermarkets are getting into the variety act too	supermarkets were getting into the variety act too
mr. andersson is anxious to strengthen trelleborg 's balance sheet	mr. andersson was anxious to strengthen trelleborg 's balance sheet
edisto currently is the general partner of nrm	edisto currently was the general partner of nrm
my relationships with the british are totally different	my relationships with the british were totally different
we are a vanishing breed he muses	we were a vanishing breed he muses
a further problem is razor-thin profits	a further problem was razor-thin profits
the bonds are insured and rated triple-a by moody 's and s&p	the bonds were insured and rated triple-a by moody 's and s&p
the struggle over capital gains is the most important game in town	the struggle over capital gains was the most important game in town
heady stuff it 's not	heady stuff it was not
maybe he thinks they should also sell to the highest bidder	maybe he thought they should also sell to the highest bidder
on balance we think it will be positive	on balance we thought it bed positive
if i need to ask for money up front later i will	if i needed to ask for money up front later i did
the value of the company has changed	the value of the company had changed
bullish bond market sentiment is on the rise again	bullish bond market sentiment was on the rise again
yet some funds have pulled in their horns	yet some funds had pulled in their horns
lackluster returns are one reason	lackluster returns were one reason
the goal of most u.s. firms joint ventures remains elusive	the goal of most u.s. firms joint ventures remained elusive
the senate will probably vote not long afterward	the senate voted not long afterward probably
he seems to be typical of many professional money managers	he seemed to be typical of many professional money managers
christmas shoppers find a helping hand from some catalog companies	christmas shoppers found a helping hand from some catalog companies
local bankers and accountants help applicants fill out forms	local bankers and accountants helped applicants filled out forms
but will it be enough	but will it bed enough
we 're in for a lot of turbulence	we were in for a lot of turbulence
it just is n't done	it just was n't done
the infusion of activists can bring a clash of cultures	the infusion of activists could bring a clash of cultures
rents have soared along with house prices	rents had soared along with house prices
generally regulators have n't announced enforcement actions in the past	generally regulators had n't announced enforcement actions in the past
we go from one to the other	we went from one to the other
since that 1976 ruling 37 states have reintroduced the death penalty	since that 1976 ruling 37 states had reintroduced the death penalty
yet if gold prices improve silver prices could rally sharply he says	yet if gold prices improved silver prices could rally sharply he said
i think a lot of people got scared and stayed home	i thought a lot of people got scared and stayed home
at first glance gold and utilities seem strange bedfellows	at first glance gold and utilities seemed strange bedfellows
the percentage change is since year-end	the percentage change was since year-end
he 's running for governor	he was running for governor
in such cases the game has n't changed only the name	in such cases the game had n't changed only the name
they can be 1 billion plus mr. richardson said	they could be 1 billion plus mr. richardson said
the utility company currently has about 82.1 million shares outstanding	the utility company currently had about 82.1 million shares outstanding
but even a little appeal has a lot of attraction these days	but even a little appeal had a lot of attraction these days
yet the group 's limited resources makes it a niche player	yet the group 's limited resources made it a niche player
veterinary products are showing especially strong growth mr. bergsma said	veterinary products were showing especially strong growth mr. bergsma said
but we do n't minimize the challenges of the near term	but we did n't minimize the challenges of the near term
do n't say it 's a gold ceiling	did n't say it was a gold ceiling
they now are experimenting with measuring blood flow	they now were experimenting with measuring blood flow
otherwise actual profit is compared with the 300-day estimate	otherwise actual profit was compared with the 300-day estimate
reward el espectador 's courage with real support	rewarded el espectador 's courage with real support
seats currently are quoted at 400,000 bid 425,000 asked	seats currently were quoted at 400,000 bid 425,000 asked
telerate has rejected the offer which expires nov. 3	telerate had rejected the offer which expired nov. 3
the accompanying table shows how this strategy would work for three stocks	the accompanying table showed how this strategy would work for three stocks
ima also will assume 1.4 billion in debt	ima also assumed 1.4 billion in debt
but he warned the currency will remain at risk	but he warned the currency remained at risk
both have become confidants of president bush	both had become confidants of president bush
you have to count everything	you had to count everything
they 've now adapted the yeast to making genetically engineered drugs	they 'ved now adapted the yeast to making genetically engineered drugs
the three existing plants and their land will be sold	the three existing plants and their land bed sold
mervin lung remains chairman and chief executive officer	mervin lung remained chairman and chief executive officer
hostile takeovers are quite a new phenomenon	hostile takeovers were quite a new phenomenon
the anticipated drop follows a 3.9 % rise in august	the anticipated drop followed a 3.9 % rise in august
an additional benefit is the creation of jobs	an additional benefit was the creation of jobs
the old crowd is deeply concerned by the backlash from all this	the old crowd was deeply concerned by the backlash from all this
an s&p rating of double-a-plus has already been confirmed	an s&p rating of double-a-plus had already been confirmed
it liquefies in a patchwork quilt pattern	it liquefied in a patchwork quilt pattern
the board has 13 members elected by holders and five presidential appointees	the board had 13 members elected by holders and five presidential appointees
looking to the past can provide some clues	looking to the past could provide some clues
it was like a play on broadway recalls mr. martinez	it was like a play on broadway recalled mr. martinez
but they think promotions are limited	but they thought promotions were limited
these mega-issues are being propelled by two factors economic and political	these mega-issues were being propelled by two factors economic and political
a supremely cautious man the fed chairman is forever blinking yellow	a supremely cautious man the fed chairman was forever blinking yellow
unable to stop his accelerating descent he crashes	unable to stop his accelerating descent he crashed
mr. lerner is a writer and historian living in new york	mr. lerner was a writer and historian living in new york
that 's ok mr. sagan replies	that was ok mr. sagan replyed
it 's much cheaper than permanent insurance bought at the same age	it was much cheaper than permanent insurance bought at the same age
that 's another reason for the backer spielvogel job	that was another reason for the backer spielvogel job
for one thing credit-card loans are unsecured	for one thing credit-card loans were unsecured
but the money is n't peanuts either particularly for a news program	but the money was n't peanuts either particularly for a news program
these figures are n't seasonally adjusted	these figures were n't seasonally adjusted
the earnings-per-share figures reflect a 25 % stock dividend in june 1989	the earnings-per-share figures reflected a 25 % stock dividend in june 1989
that 's beginning to change	that was beginning to change
healthcare operates many of the health-care properties that healthvest owns	healthcare operated many of the health-care properties that healthvest owned
experts say such long hours for attendants pose a safety risk	experts said such long hours for attendants posed a safety risk
the subscribers are in 52 different communities in georgia alabama and mississippi	the subscribers were in 52 different communities in georgia alabama and mississippi
all anyone need do is hang up a shingle and start planning	all anyone need do was hung up a shingle and start planning
there is n't a big shot an agenda	there was n't a big shot an agenda
we 're after a little bigger niche he said	we were after a little bigger niche he said
similarly the big board hopes to entice merrill lynch & co	similarly the big board hopped to entice merrill lynch & co
so the federal reserve is an attractive target for complaint by politicians	so the federal reserve was an attractive target for complaint by politicians
the second factor spurring mega-issues is political	the second factor spurring mega-issues was political
the california thrift has just announced a 226 million third-quarter loss	the california thrift had just announced a 226 million third-quarter loss
anatol pawlowski 's leg begins jiggling beneath his desk	anatol pawlowski 's leg began jiggling beneath his desk
but under alan greenspan that has changed	but under alan greenspan that had changed
the new rules will allow investors to buy foreign stocks directly	the new rules allowed investors to buy foreign stocks directly
other furriers have also benefited from leathers	other furriers had also benefited from leathers
you think you can go out and turn things around	you thought you could go out and turn things around
the market 's pessimism reflects the gloomy outlook in detroit	the market 's pessimism reflected the gloomy outlook in detroit
it will be very expensive the spokesman warned	it bed very expensive the spokesman warned
and black-and-white photography classes are crowded with students	and black-and-white photography classes were crowded with students
volume has been appalling said a dealer at a british brokerage concern	volume had been appalling said a dealer at a british brokerage concern
nuclear power plants are acceptable	nuclear power plants were acceptable
the result is mistrust and criticism from all around	the result was mistrust and criticism from all around
hearings have n't yet been set in texas ohio and kansas	hearings had n't yet been set in texas ohio and kansas
pse has about 9.2 million shares outstanding	pse had about 9.2 million shares outstanding
at that rate the defense plan is underfunded by 48 billion	at that rate the defense plan was underfunded by 48 billion
the zero-coupon subordinated notes have no periodic interest payments	the zero-coupon subordinated notes had no periodic interest payments
the central bank has been helping but apparently not especially eagerly	the central bank had been helping but apparently not especially eagerly
intra-european takeovers are expected to continue at their brisk pace	intra-european takeovers were expected to continue at their brisk pace
we can lose money on this he says	we could lose money on this he said
the measure is expected to move through this congress	the measure was expected to move through this congress
press agents and public-relations practitioners are notorious name-droppers	press agents and public-relations practitioners were notorious name-droppers
if you are born to give parties you give parties	if you were born to give parties you gave parties
viroqua serves about 3,000 access lines in western wisconsin	viroqua served about 3,000 access lines in western wisconsin
one step is to beef up its fleet	one step was to beef up its fleet
the fed also has the power to set margin requirements	the fed also had the power to set margin requirements
they 're in the midst of a turnaround she noted	they were in the midst of a turnaround she noted
censorship is n't a marxist invention	censorship was n't a marxist invention
the closely held company has n't disclosed sales	the closely held company had n't disclosed sales
it 's that we do n't want to	it was that we did n't want to
there are still others who do n't mind seeing new crises arise	there were still others who did n't mind seeing new crises arose
investment and emigration plans take time to come to fruition	investment and emigration plans took time to come to fruition
the minimum unit is 100,000	the minimum unit was 100,000
well they can now go and audition there	well they could now go and audition there
the interest-only securities will be sold separately by bt securities	the interest-only securities bed sold separately by bt securities
hugo's blast generates pleas for aid from south carolina small businesses	hugo's blast generated pleas for aid from south carolina small businesses
there will be recreation and movie rooms	there were recreation and movie rooms
darman hopes to prod congress to finish a deficit plan	darman hopped to prod congress to finish a deficit plan
hospital regulation sparks kentucky feud	hospital regulation sparked kentucky feud
now it is their fellow turks arriving as refugees from bulgaria	now it was their fellow turks arriving as refugees from bulgaria
at the core of all this stands a hotel	at the core of all this stood a hotel
the meeting is expected to call for heightened austerity for two years	the meeting was expected to call for heightened austerity for two years
golenbock with 35 lawyers has lost several partners during the past year	golenbock with 35 lawyers had lost several partners during the past year
the trial begins today in federal court in philadelphia	the trial began today in federal court in philadelphia
it adds something to the market	it added something to the market
it 's going to get bloody	it was going to get bloody
briggs screamed mr. windsor recalls	briggs screamed mr. windsor recalled
in los angeles it 's important to catch people just after work	in los angeles it was important to catch people just after work
mr. kendrick is professor emeritus of economics at george washington university	mr. kendrick was professor emeritus of economics at george washington university
the shuttle is slated to return monday to california	the shuttle was slated to return monday to california
some analysts are cynical about the new corporate interest in health-care overhaul	some analysts were cynical about the new corporate interest in health-care overhaul
but traders who risk money handling big blocks of stock were shaken	but traders who risked money handling big blocks of stock were shaken
those enterprises however are not going to be privatized	those enterprises however were not going to be privatized
proceeds of the issue will be used for general government purposes	proceeds of the issue bed used for general government purposes
that task is one of washington 's perennial problems	that task was one of washington 's perennial problems
but she says i guess i did n't really notice the trees	but she said i guessed i did n't really notice the trees
some conservatives will accuse the president of promising congress too much	some conservatives accused the president of promising congress too much
hotel-casino operators play down the possibility of a labor shortage	hotel-casino operators played down the possibility of a labor shortage
the debentures are available through goldman sachs & co	the debentures were available through goldman sachs & co
taste has finally come to the fore he says	taste had finally come to the fore he said
mr. coffee is a professor at columbia law school	mr. coffee was a professor at columbia law school
for financial analysts reading omni 's accounts is a tough challenge	for financial analysts reading omni 's accounts was a tough challenge
i do not by any means defend hud management	i did not by any means defend hud management
the reason does n't relate to your selling skills	the reason did n't relate to your selling skills
the protesters point out that galileo also could crash to earth then	the protesters pointed out that galileo also could crash to earth then
mr. schwartz is a business executive and writer in new york	mr. schwartz was a business executive and writer in new york
some are even coming up with their own novel designs	some were even coming up with their own novel designs
traders expect the issue to be priced to yield 12 %	traders expected the issue to be priced to yield 12 %
housing developers try brand-name buildings	housing developers tryed brand-name buildings
we view it as a good long-term investment the spokesman said	we viewed it as a good long-term investment the spokesman said
some stock-index funds are huge	some stock-index funds were huge
the company plans to be fully operational today	the company planned to be fully operational today
richard stoltzman has taken a gentler more audience-friendly approach	richard stoltzman had taken a gentler more audience-friendly approach
the new pricing strategy is working the spokesman asserted	the new pricing strategy was working the spokesman asserted
about 550 million of long-term debt is affected according to moody 's	about 550 million of long-term debt was affected according to moody 's
serial certificates yield to 7.10 % in 2004	serial certificates yielded to 7.10 % in 2004
for instance employment in denver will be reduced to 105 from 430	for instance employment in denver bed reduced to 105 from 430
texas is big and beautiful and they live here that 's all	texas was big and beautiful and they lived here that was all
and the risks are n't appropriate for us he says	and the risks were n't appropriate for us he said
nesb is also the parent of omnibank	nesb was also the parent of omnibank
but that does n't mean i 'm not going to get angry	but that did n't mean i was not going to get angry
but value it turns out is only what a buyer will pay	but value it turned out was only what a buyer paid
sounds great or does it	sounded great or does it
white children empty the wastepaper baskets and squeegee the windows	white children emptied the wastepaper baskets and squeegee the windows
ldi leases and sells data-processing telecommunications and other high-tech equipment	ldi leased and sells data-processing telecommunications and other high-tech equipment
the market seems increasingly disconnected from the rest of the nation	the market seemed increasingly disconnected from the rest of the nation
the move is likely to anger traders	the move was likely to anger traders
still time 's move is being received well once again	still time 's move was being received well once again
there is no mystery why the delta originated singin the blues	there was no mystery why the delta originated singin the blues
both revenue figures exclude excise taxes	both revenue figures excluded excise taxes
the public is very close to having had it mr. jenks says	the public was very close to having had it mr. jenks said
said the spokeswoman the whole structure has changed	said the spokeswoman the whole structure had changed
they 're more worried about bread on the table	they were more worried about bread on the table
the merged firm will carry norris mclaughlin 's name	the merged firm carryed norris mclaughlin 's name
many also use recruiting bonuses tuition reimbursement loan repayment or child-care help	many also used recruiting bonuses tuition reimbursement loan repayment or child-care help
the 3,000 hours of work will save the state 55,000	the 3,000 hours of work saved the state 55,000
i want to add one more truck mr. huber says	i wanted to add one more truck mr. huber said
citicorp and chase are attempting to put together a new lower bid	citicorp and chase were attempting to put together a new lower bid
the position of chief operating officer is new	the position of chief operating officer was new
a cultural center has been built shops	a cultural center had been built shops
prospective competition is one problem	prospective competition was one problem
we will vigorously oppose the bill he says	we vigorously oppose the bill he said
it 's a sound phenomenon	it was a sound phenomenon
china 's land and labor offer inexpensive alternatives to local industry	china 's land and labor offered inexpensive alternatives to local industry
daily living is the best possible investment	daily living was the best possible investment
take your vacation in a hurricane area	took your vacation in a hurricane area
there will be no sightseeing no shopping and no social events	there was no sightseeing no shopping and no social events
a private farmer never wastes anything	a private farmer never wasted anything
indeed institutions already are taking note	indeed institutions already were taking note
mr. labovitz is president of odi a consulting firm in burlington mass	mr. labovitz was president of odi a consulting firm in burlington mass
in texas taxes and development costs are also lower they said	in texas taxes and development costs were also lower they said
i do n't want to feel guilty representing my constituents	i did n't want to feel guilty representing my constituents
the catalyst for all this has been opec	the catalyst for all this had been opec
digital 's new line has been a long time coming	digital 's new line had been a long time coming
these days anything can happen	these days anything could happen
the offer has an indicated value of 268 million	the offer had an indicated value of 268 million
once they are in the building they stay	once they were in the building they stayed
i see a possibility of going to 2200 this month	i saw a possibility of going to 2200 this month
y&r 's klein steps down	y&r 's klein stepped down
he 's a genuine wheaties-box athlete gushes mr. jones	he was a genuine wheaties-box athlete gushed mr. jones
but the company declines to comment	but the company declined to comment
it 's a tough thing when you ca n't	it was a tough thing when you ca n't
so far this list does n't change our view	so far this list did n't change our view
we 've actually read the speech	we 'ved actually read the speech
the independent-contractor project which began in 1988 involves about 350 irs agents	the independent-contractor project which began in 1988 involved about 350 irs agents
that 's more than 10 times the usual housing site size	that was more than 10 times the usual housing site size
and it 's important that we be accurate	and it was important that we bed accurate
this time though he says i think we got it	this time though he said i thought we got it
mr. rezneck is a lawyer in washington d.c	mr. rezneck was a lawyer in washington d.c
cbs will continue to program action-adventure shows to follow the sajak hour	cbs continued to program action-adventure shows to follow the sajak hour
it comes real gentle before it pulls	it came real gentle before it pulled
responding to that demand however has led to a variety of compromises	responding to that demand however had led to a variety of compromises
investors will develop thicker skins and their confidence will return he says	investors developped thicker skins and their confidence returned he said
this is the commercial version	this was the commercial version
simply put there is n't enough business for every store to grow	simply put there was n't enough business for every store to grow
billing is included in a caller 's regular phone bill	billing was included in a caller 's regular phone bill
when the computer says switch renaissance switches	when the computer said switched renaissance switched
now after beating them mr. achenbaum is joining them	now after beating them mr. achenbaum was joining them
most recently a lack of buyers has been added to the list	most recently a lack of buyers had been added to the list
that is the way the system works	that was the way the system worked
the british economy is hardly the picture of health these days	the british economy was hardly the picture of health these days
the notice also grants relief for certain estate-tax returns	the notice also granted relief for certain estate-tax returns
gate receipts are only the cowboys ' second largest source of cash	gate receipts were only the cowboys ' second largest source of cash
the price also includes assumption of about 1.4 billion in debt	the price also included assumption of about 1.4 billion in debt
they eat sinful and sensual things and explain their clips	they ate sinful and sensual things and explain their clips
it has never been done before but there 's always a first	it had never been done before but there was always a first
the u.s. futures exchanges compete world-wide as never before	the u.s. futures exchanges competed world-wide as never before
all agencies are new york-based	all agencies were new york-based
entrepreneurs do n't rush to get into a stagnant or declining industry	entrepreneurs did n't rush to get into a stagnant or declining industry
one key for salespeople is to boost their own morale	one key for salespeople was to boost their own morale
does this signal another black monday is coming	does this signaled another black monday was coming
the market for electrochemicals include the paper water-purification and textile industries	the market for electrochemicals included the paper water-purification and textile industries
with the market overbuilt builders are finding limited opportunities and increased risks	with the market overbuilt builders were finding limited opportunities and increased risks
still mr. johnson said our stock is grossly undervalued	still mr. johnson said our stock was grossly undervalued
the company is an independent refined-petroleum-products pipeline serving six western states	the company was an independent refined-petroleum-products pipeline serving six western states
polysilicon is used in making integrated circuits	polysilicon was used in making integrated circuits
first however he has unfinished business	first however he had unfinished business
any fool can publish a money-losing magazine	any fool could publish a money-losing magazine
the 650-or-so local whites who are n't orange workers are more troubled	the 650-or-so local whites who were n't orange workers were more troubled
the 1989 americans with disabilities act is about eliminating discriminatory barriers	the 1989 americans with disabilities act was about eliminating discriminatory barriers
dpc holds about 7.8 % of dataproducts ' shares	dpc held about 7.8 % of dataproducts ' shares
partly costs will be held down through strategic technology alliances management said	partly costs bed held down through strategic technology alliances management said
health benefits remain a central lobbying effort even as section 89 fades	health benefits remained a central lobbying effort even as section 89 fades
the supply of experienced civil engineers though is tighter	the supply of experienced civil engineers though was tighter
it smacks of big brotherism	it smacked of big brotherism
they are buying an operation that is running well	they were buying an operation that was running well
i 'm not interested said dallas investor harold simmons	i was not interested said dallas investor harold simmons
a panic on wall street does n't exactly inspire confidence	a panic on wall street did n't exactly inspire confidence
anyone telling you to buy stocks in this market is technically irresponsible	anyone telling you to buy stocks in this market was technically irresponsible
this does n't mean they 're less likely to live alone however	this did n't mean they were less likely to live alone however
but that 's not the only problem for stocks	but that was not the only problem for stocks
hopes of simplifying the corporate minimum tax before 1990 are weakening	hopes of simplifying the corporate minimum tax before 1990 were weakening
the venture cost quebecor 12 million mr. peladeau says	the venture cost quebecor 12 million mr. peladeau said
this is a story about suckers	this was a story about suckers
as a result u.s. trust 's earnings have been hurt	as a result u.s. trust 's earnings had been hurt
the best odds are with your core franchise	the best odds were with your core franchise
with all this can stock prices hold their own	with all this can stock prices held their own
radio programs and books have followed the daily television show	radio programs and books had followed the daily television show
those viewers find the show confusing	those viewers found the show confusing
mr. warren pronounces the litchfield case your typical demonic infestation	mr. warren pronounced the litchfield case your typical demonic infestation
but margins will be helped too by some other cost-saving steps	but margins bed helped too by some other cost-saving steps
but funds generally are better prepared this time around	but funds generally were better prepared this time around
a bus is the data highway within a computer	a bus was the data highway within a computer
he also leads an opulent life style	he also led an opulent life style
the lone star is on the rise again	the lone star was on the rise again
daiwa is one of the world 's largest securities firms	daiwa was one of the world 's largest securities firms
it will continue to be sold in the european market	it continued to be sold in the european market
in these circumstances i think they 'd win	in these circumstances i thought they 'd win
it all adds up to a cold winter here	it all added up to a cold winter here
first the price of natural gas will have to almost double	first the price of natural gas had to almost double
older properties that still have a 1950s image are also vulnerable	older properties that still had a 1950s image were also vulnerable
mr. quennell has said he plans to go with the grid regardless	mr. quennell had said he planned to go with the grid regardless
inflation is at record levels	inflation was at record levels
such bonds she says are those that are nearing their call date	such bonds she said were those that were nearing their call date
it implies very dramatic growth he said	it implyed very dramatic growth he said
firms walk fine line in distributing profits	firms walked fine line in distributing profits
critics also say american companies charge too much	critics also said american companies charged too much
iowa is making a comeback	iowa bed making a comeback
so the older or most inefficient capacity has got to go	so the older or most inefficient capacity had got to go
silver production is also in an inexorable upward trend ms. o'connell says	silver production was also in an inexorable upward trend ms. o'connell said
the results show sears is struggling to attract shoppers	the results showed sears was struggling to attract shoppers
we are the producers of that movie	we were the producers of that movie
and many have done just that	and many had done just that
people comfortable with the passive approach are using them for other strategies	people comfortable with the passive approach were using them for other strategies
trouble is junk bond prices have been weak for months	trouble was junk bond prices had been weak for months
it 's tabloid news from a to z	it was tabloid news from a to z
on isaac stern 's recording it 's very biting	on isaac stern 's recording it was very biting
the merksamer bankruptcy-law filing appears to supersede that agreement	the merksamer bankruptcy-law filing appeared to supersede that agreement
i happen to think it was right mr. bush said flatly	i happenned to think it was right mr. bush said flatly
the construction industry is sure to feel increased demand	the construction industry was sure to feel increased demand
you already know the answer	you already knew the answer
and catastrophes are getting ever more costly	and catastrophes were getting ever more costly
but no one has made a serious effort to transplant the crop	but no one had made a serious effort to transplant the crop
favored ventures include media telecommunications and retailing	favored ventures included media telecommunications and retailing
suddenly i am not a comfortable man for solidarity	suddenly i was not a comfortable man for solidarity
loyalty lags most for utilitarian products like trash bags and batteries	loyalty lagged most for utilitarian products like trash bags and batteries
the committee also has summoned mr. wall 's predecessor edwin gray	the committee also had summoned mr. wall 's predecessor edwin gray
the bonds are expected to have a 14 1\/2 % coupon rate	the bonds were expected to have a 14 1\/2 % coupon rate
he visits the same department every two or three weeks	he visitted the same department every two or three weeks
a lot of the professional traders are just going back and forth	a lot of the professional traders were just going back and forth
the diplomat adds that mr. krenz has several things going for him	the diplomat added that mr. krenz had several things going for him
certainly the recent drop in prices does n't mean manhattan comes cheap	certainly the recent drop in prices did n't mean manhattan came cheap
i do n't know if this would have happened somewhere else	i did n't know if this would have happened somewhere else
defining combat aircraft is even tougher	defining combat aircraft was even tougher
advertisers are resisting higher prices which would help close the gap	advertisers were resisting higher prices which would help close the gap
this cuts down greatly on labor mr. buchner said	this cut down greatly on labor mr. buchner said
they are awaiting an arbitration proceeding	they were awaiting an arbitration proceeding
this hurts the price of corporate bonds	this hurt the price of corporate bonds
in recent years growth has come in the foreign markets	in recent years growth had come in the foreign markets
the new closed-end management investment company trades shares of beneficial interest	the new closed-end management investment company traded shares of beneficial interest
hoping to stay ahead of the pack the company is emphasizing innovation	hoping to stay ahead of the pack the company was emphasizing innovation
but going against the grain has never bothered mr. andersson	but going against the grain had never bothered mr. andersson
brockville is about 100 miles east of toronto	brockville was about 100 miles east of toronto
cnn wants to change its viewers ' habits	cnn wanted to change its viewers ' habits
i think the market will be heading down into november he says	i thought the market bed heading down into november he said
other furriers have also placed more weight on retailing	other furriers had also placed more weight on retailing
evaluating asset-backed securities poses another problem	evaluating asset-backed securities posed another problem
this sets things way back	this set things way back
the republicans show no sign of relenting	the republicans showed no sign of relenting
ira himself confirms this account	ira himself confirmed this account
the industry is overbuilt he says	the industry was overbuilt he said
lack of liquidity can also result from exchange reforms	lack of liquidity could also result from exchange reforms
harsco produces products for defense industrial commercial and construction markets	harsco produced products for defense industrial commercial and construction markets
but mr. runkel contends there has been no exodus of strike-force lawyers	but mr. runkel contended there had been no exodus of strike-force lawyers
veiling his message has helped him endure	veiling his message had helped him endured
some have been training for months others only recently left active status	some had been training for months others only recently left active status
people were even hoarding bags he says	people were even hoarding bags he said
others prefer deep-discount zero-coupon bonds	others prefered deep-discount zero-coupon bonds
the machine employs reduced instruction-set computing or risc technology	the machine employed reduced instruction-set computing or risc technology
a normal person did not write the beethoven violin concerto he declares	a normal person did not write the beethoven violin concerto he declared
the cost of competition has become extremely high he says	the cost of competition had become extremely high he said
i 've done what i came to do at kidder he says	i 'ved done what i came to do at kidder he said
they do n't have the votes to get it passed	they did n't have the votes to get it passed
likewise no government will stop this idea of the afrikaners	likewise no government stopped this idea of the afrikaners
the comptroller 's office says it is monitoring the situation	the comptroller 's office said it was monitoring the situation
they contend that sci tv 's equity now is worthless	they contended that sci tv 's equity now was worthless
with krenz we just do n't know what to expect	with krenz we just did n't know what to expect
all parts of the issue are callable at any time at par	all parts of the issue were callable at any time at par
we 're very pleased with the new deal	we were very pleased with the new deal
pro-life advocates say the white house never wavered over the veto	pro-life advocates said the white house never wavered over the veto
telerate provides information about financial markets through an electronic network	telerate provided information about financial markets through an electronic network
this is just not so	this was just not so
each one has a different agenda	each one had a different agenda
rest assured we proceed with exemplary fairness	rested assured we proceeded with exemplary fairness
mining is likely to remain trelleborg 's main business	mining was likely to remain trelleborg 's main business
until then the billions hud spends on inner-city housing simply is wasted	until then the billions hud spent on inner-city housing simply was wasted
consider for instance the very fat fowl known as federalized child care	considered for instance the very fat fowl knew as federalized child care
and real estate usually has n't traded well under public ownership	and real estate usually had n't traded well under public ownership
and pregnant women are fat	and pregnant women were fat
but the worriers remain unconvinced	but the worriers remained unconvinced
norton makes sandpaper and other abrasives diamond tools specialty plastics and ceramics	norton made sandpaper and other abrasives diamond tools specialty plastics and ceramics
indeed abortion-rights activists still face their greatest tests	indeed abortion-rights activists still faced their greatest tests
why did he add the value fund to the list	why did he added the value fund to the list
the damage is already done	the damage was already done
still there is money to be made	still there was money to be made
the series typically is among the highest-rated sports events on television	the series typically was among the highest-rated sports events on television
the result is that the unthinkable and illogical are happening	the result was that the unthinkable and illogical were happening
the notes are rated mig-1 by moody 's investors service inc	the notes were rated mig-1 by moody 's investors service inc
hewlett-packard will charge 5,000 for a license covering 10 users	hewlett-packard charged 5,000 for a license covering 10 users
the market upheaval apparently has n't triggered any cash crunch yet	the market upheaval apparently had n't triggered any cash crunch yet
now everybody is a lot more optimistic	now everybody was a lot more optimistic
the plan is talking about applicants admitted not students who enroll	the plan was talking about applicants admitted not students who enrolled
the sustainability of u.s. foreign policy is essential he explains	the sustainability of u.s. foreign policy was essential he explained
coopers uses the coopers & lybrand name world-wide	coopers used the coopers & lybrand name world-wide
many people now claim to have predicted the 1987 crash	many people now claimed to have predicted the 1987 crash
bush and deng are hoping that cooler heads prevail	bush and deng were hoping that cooler heads prevailed
but trading risk stems from credit risk	but trading risk stemmed from credit risk
and the potential market is tremendous industry experts say	and the potential market was tremendous industry experts said
the bare-faced messiah decision strikes a blow against the whole historical enterprise	the bare-faced messiah decision struck a blow against the whole historical enterprise
rates approach 6.5 % on five-year municipals	rates approached 6.5 % on five-year municipals
to ask those questions is to answer them	to ask those questions was to answer them
the completion of the merger agreement follows months of twists and turns	the completion of the merger agreement followed months of twists and turns
the state will vigorously defend against any counterclaim	the state defended against any counterclaim vigorously
its attendance is off 23 % from six years ago	its attendance was off 23 % from six years ago
no one ever eats in their books and look at them	no one ever ate in their books and looked at them
various cultural and economic forces have suppressed demand	various cultural and economic forces had suppressed demand
but we 're just too nervous	but we were just too nervous
analysts predict little or no near-term growth	analysts predicted little or no near-term growth
but there were supposed to be three mr. wathen 's company claims	but there were supposed to be three mr. wathen 's company claimed
here are details of the auction	here were details of the auction
jury convicts congressman in connection with wedtech corp. scandal	jury convicted congressman in connection with wedtech corp. scandal
known as easy eggs the product has disappointed investors	known as easy eggs the product had disappointed investors
people in the phone business call this technology 900 click	people in the phone business called this technology 900 click
the second is they do n't have enough discipline	the second was they did n't have enough discipline
the answer is n't price reductions but new systems he said	the answer was n't price reductions but new systems he said
consider the new america high income fund	considered the new america high income fund
clearly people like mrs. lombardi are giving marketers fits	clearly people like mrs. lombardi were giving marketers fits
upgrades to bigger models also will be costlier	upgrades to bigger models also bed costlier
that hurts investors ' confidence in the economy and stocks	that hurt investors ' confidence in the economy and stocks
that is the state of japan 's computer industry	that was the state of japan 's computer industry
that certainly is not the supposed distorted reading indicated by mr. lantos	that certainly was not the supposed distorted reading indicated by mr. lantos
those chains include bloomingdale 's which campeau recently said it will sell	those chains included bloomingdale 's which campeau recently said it will sell
after that it will make a final decision on the policy	after that it made a final decision on the policy
the suit seeks unspecified damages	the suit seeked unspecified damages
over the next several months though he says things look bad	over the next several months though he said things looked bad
mr. maynard says the ruling pushed his company into bankruptcy court	mr. maynard said the ruling pushed his company into bankruptcy court
i really want to see that happen again	i really wanted to see that happenned again
blue chips he says are now being referred to as poker chips	blue chips he said were now being referred to as poker chips
i 'm sure he still wants amr	i was sure he still wanted amr
what happens to me if campeau collapses between now and then	what happenned to me if campeau collapsed between now and then
there 's no fire sale here	there was no fire sale here
you talk about free time .what free time	you talked about free time .what free time
you have to be born with it	you had to be born with it
wcrs has been in discussions with eurocom for several months	wcrs had been in discussions with eurocom for several months
turkey in any event is long past it	turkey in any event was long past it
it takes three months to turn copper concentrate into cathodes he said	it took three months to turn copper concentrate into cathodes he said
other network applications have very different goals	other network applications had very different goals
but even mr. boren defends congressional oversight	but even mr. boren defended congressional oversight
only two of 111 transplants have been rejected	only two of 111 transplants had been rejected
eagle 's plastic type sharpens and looks like a wooden pencil	eagle 's plastic type sharpenned and looks like a wooden pencil
the article is unfortunately replete with outrageous distortions	the article was unfortunately replete with outrageous distortions
it 's the total relationship that is important	it was the total relationship that was important
the system also provides course-correction advisories	the system also provided course-correction advisories
but sophistication has its limits	but sophistication had its limits
mr. fried also is the managing partner of albert fried & co	mr. fried also was the managing partner of albert fried & co
the dividend is payable dec. 15 to stock of record nov. 15	the dividend was payable dec. 15 to stock of record nov. 15
that means stocks bonds money market instruments and real estate	that meant stocks bonds money market instruments and real estate
some people must drop names call it an irresistible impulse	some people must drop names called it an irresistible impulse
he is a mechanical engineer not an atmospheric chemist	he was a mechanical engineer not an atmospheric chemist
within 25 years jews will probably be the minority	within 25 years jews bed the minority probably
it 's a whole new generation he said	it was a whole new generation he said
but the market is changing	but the market was changing
small-business interests have lobbied against the so-called section 89 tax rules	small-business interests had lobbied against the so-called section 89 tax rules
now in the '90s we 're headed toward a total resort environment	now in the '90s we were headed toward a total resort environment
only recently has it been attractively redesigned and its editorial product improved	only recently has it bed attractively redesigned and its editorial product improved
that means huge travel bills	that meant huge travel bills
now they do n't have to he says	now they did n't have to he said
x year-to-date 1988 figure includes volkswagen domestic-production through july	x year-to-date 1988 figure included volkswagen domestic-production through july
but it 's rare to see both functions in one case	but it was rare to see both functions in one case
the air force is to take at least 250 more	the air force was to take at least 250 more
but in 1989 most senators have other ideas	but in 1989 most senators had other ideas
i 'm going to hold on	i was going to hold on
whittle is spending 150 million initially to launch the network	whittle was spending 150 million initially to launch the network
those who bought that illusion are now bewildered	those who bought that illusion were now bewildered
it 's like an oasis in this room ms. foster purrs	it was like an oasis in this room ms. foster purred
coupon paid monthly is one-month canadian bankers acceptance rate	coupon paid monthly was one-month canadian bankers acceptance rate
in tokyo trading is halted during lunchtime	in tokyo trading was halted during lunchtime
we 're meeting and surpassing our goals he added	we were meeting and surpassing our goals he added
disclosures are very poor in india	disclosures were very poor in india
nor does it cover the entire portfolio	nor does it covered the entire portfolio
both issues are dated oct. 19	both issues were dated oct. 19
i think a lot of their businesses are just so-so	i thought a lot of their businesses were just so-so
the minimum unit is 100,000	the minimum unit was 100,000
in the latest quarter at least profit is expected to fall sharply	in the latest quarter at least profit was expected to fall sharply
trinidad corp. is contesting liability	trinidad corp. was contesting liability
and centenarians fly free in first class	and centenarians flew free in first class
home nutritional currently has 10 million shares outstanding	home nutritional currently had 10 million shares outstanding
reggie jackson the retired baseball star has found another use for them	reggie jackson the retired baseball star had found another use for them
it is not surprising that parents find this romantic extravagance so attractive	it was not surprising that parents found this romantic extravagance so attractive
why be a middleman for charitable gifts a retiree asks	why bed a middleman for charitable gifts a retiree asked
to transmit charts to branch offices they use a fax machine	to transmit charts to branch offices they used a fax machine
they check in but they ca n't check out	they checked in but they ca n't check out
dick darman call your office	dick darman called your office
but in general all foreign-trading companies are feeling the pinch	but in general all foreign-trading companies were feeling the pinch
it takes one person 's account and gives it authenticity	it took one person 's account and gives it authenticity
kidder peabody & co. is trying to struggle back	kidder peabody & co. was trying to struggle back
the notion that tracking is somehow undemocratic is absurd	the notion that tracking was somehow undemocratic was absurd
this plays right into the hands of the advertising agencies	this played right into the hands of the advertising agencies
we are having a regular day	we were having a regular day
excluding mexico reserves equal 95 % of ldc exposure	excluding mexico reserves equaled 95 % of ldc exposure
usx is funneling drilling pipe to steel-hungry soviet union	usx was funneling drilling pipe to steel-hungry soviet union
now i feel maybe there 's a little bit of euphoria	now i felt maybe there was a little bit of euphoria
the bonds are insured and rated triple-a by moody 's and s&p	the bonds were insured and rated triple-a by moody 's and s&p
mr. redford no longer stands out as an extremist	mr. redford no longer stood out as an extremist
mr. kochan also likes long-term investment-grade corporate bonds and long-term treasurys	mr. kochan also liked long-term investment-grade corporate bonds and long-term treasurys
it 's a real dog	it was a real dog
but the americans are also to blame	but the americans were also to blame
he takes over a school system in the midst of radical reform	he took over a school system in the midst of radical reform
if sex is involved all bets are off	if sex bed involved all bets bed off
young & rubicam has pleaded innocent to the charges	young & rubicam had pleaded innocent to the charges
atlanta mr. savageau sniffs has unrealistic pretensions to world-class status	atlanta mr. savageau sniffed had unrealistic pretensions to world-class status
our teachers are not an important factor in our educational crisis	our teachers were not an important factor in our educational crisis
like just about everything else that remains to be seen	like just about everything else that remained to be seen
it 's difficult to be that consistently wrong	it was difficult to be that consistently wrong
u.s. and british law firms announce rare joint venture in tokyo	u.s. and british law firms announced rare joint venture in tokyo
but now the soft-drink giant appears willing to take the risk	but now the soft-drink giant appeared willing to take the risk
american brands just had a different approach mr. wathen says	american brands just had a different approach mr. wathen said
it makes investment castings and has traded over-the-counter	it made investment castings and has traded over-the-counter
if the economy turns down such proposals could gain strong momentum	if the economy turned down such proposals could gain strong momentum
these benefits seem secure despite china 's current economic and political troubles	these benefits seemed secure despite china 's current economic and political troubles
more venturesome businesses are applying their skills in commercial fields	more venturesome businesses were applying their skills in commercial fields
charlie brown is selling out	charlie brown was selling out
one early user is nec corp. 's u.s. printer marketing arm	one early user was nec corp. 's u.s. printer marketing arm
total return is price changes plus interest income	total return was price changes plus interest income
i do n't think we do now he says	i did n't think we did now he said
some dealers say other traders were n't picking up their phones	some dealers said other traders were n't picking up their phones
i 'm talking about landing in a canal	i was talking about landing in a canal
independent drillers are gingerly sinking bits into the earth 's crust again	independent drillers were gingerly sinking bits into the earth 's crust again
a prospectus in india does n't always tell a potential investor much	a prospectus in india did n't always tell a potential investor much
lack of important needed information can cause fear	lack of important needed information could cause fear
\*\* year ago figure is restated	\*\* year ago figure was restated
mr. straszheim expects he will take some heat and he 's right	mr. straszheim expected he took some heat and he was right
the name of the game is to move goods	the name of the game was to move goods
mr. thompson is n't bereft of experience with new products however	mr. thompson was n't bereft of experience with new products however
silicon graphics ' strategy seems to be paying off	silicon graphics ' strategy seemed to be paying off
there is no recovery period it 's go go go	there was no recovery period it was go go go
manufacturers have survived the turmoil in china largely unscathed	manufacturers had survived the turmoil in china largely unscathed
richard l. sherman 42 will advise midsized businesses	richard l. sherman 42 advised midsized businesses
but at least they show up	but at least they showed up
sam ramirez and his men are late	sam ramirez and his men were late
the company plans to expand plant capacity 50 % by 1991	the company planned to expand plant capacity 50 % by 1991
would n't the japanese like a piece of it	would n't the japanese liked a piece of it
the minimum unit is 100,000	the minimum unit was 100,000
the conversion price for the debentures is 41.725 a share	the conversion price for the debentures was 41.725 a share
trading in hang seng index futures remains crippled by the experience	trading in hang seng index futures remained crippled by the experience
says mr. simpson the script was unreadable	said mr. simpson the script was unreadable
today morgenzon is a town of 800 whites and two paved roads	today morgenzon was a town of 800 whites and two paved roads
some economists and many japanese companies are puzzled by the warnings	some economists and many japanese companies were puzzled by the warnings
another big difference between 1987 and 1989 is n't so comforting	another big difference between 1987 and 1989 was n't so comforting
dig is the vehicle being used to pursue to acquisition	dig was the vehicle being used to pursue to acquisition
market moves these managers do n't	market moved these managers did n't
the agency plans to announce specific relief procedures in the coming days	the agency planned to announce specific relief procedures in the coming days
it currently is considering bidding for swedish match co	it currently was considering bidding for swedish match co
she wants things to be exciting	she wanted things to be exciting
u.s. clearance also is needed for the proposed acquisition	u.s. clearance also was needed for the proposed acquisition
but so far mr. paul and his advisers are holding fast	but so far mr. paul and his advisers were holding fast
bob stone is a fictional name but the incident described is real	bob stone was a fictional name but the incident described was real
out of the 2 charge the law firm pockets about 1.55	out of the 2 charge the law firm pocketted about 1.55
senior citizens have long received cheap air fares	senior citizens had long received cheap air fares
there is nothing wrong with the economy all the indices are up	there was nothing wrong with the economy all the indices were up
we 're extremely committed to optical storage technology he said	we were extremely committed to optical storage technology he said
south carolina deserves an a for its quick and timely relief efforts	south carolina deserved an a for its quick and timely relief efforts
but these wide swings scare them to death	but these wide swings scared them to death
some companies are confident that they 're prepared	some companies were confident that they were prepared
mr. thal says that elizabeth taylor a client hates being called liz	mr. thal said that elizabeth taylor a client hatted being called liz
sonet or synchronous optical network products have more capacity than earlier models	sonet or synchronous optical network products had more capacity than earlier models
they figure it 's not a very good advert	they figured it was not a very good advert
the fact of the matter is i am a marketer	the fact of the matter was i was a marketer
imperial cup has annual sales of approximately 75 million	imperial cup had annual sales of approximately 75 million
but if he 's sharp and quick he has a chance	but if he was sharp and quick he had a chance
the estimate includes the results of new stores	the estimate included the results of new stores
if people are n't buying you have to close plants he said	if people were n't buying you had to close plants he said
mazda makes the tracer for ford	mazda made the tracer for ford
it 's going to bring the debate right back to the forefront	it was going to bring the debate right back to the forefront
analysts say usair has great promise	analysts said usair had great promise
now neither side the u.s. nor mr. noriega has an easy out	now neither side the u.s. nor mr. noriega had an easy out
the new zealand bond issue simply has brought the two institutions face-to-face	the new zealand bond issue simply had brought the two institutions face-to-face
and export business is still good	and export business was still good
researchers can apply for permission to use the probes for brain studies	researchers could apply for permission to use the probes for brain studies
they 're buying whatever 's cheaper	they were buying whatever was cheaper
the hastings mich. concern makes piston rings filters and fuel pumps	the hastings mich. concern made piston rings filters and fuel pumps
the two producers own a combined 28 % stake in guber-peters	the two producers owned a combined 28 % stake in guber-peters
the year-earlier results have been restated to reflect an accounting change	the year-earlier results had been restated to reflect an accounting change
they believe the media including batibot have played a crucial role	they believed the media including batibot had played a crucial role
he already has finagled a 2 billion loan from the japanese government	he already had finagled a 2 billion loan from the japanese government
the most likely winner will be the marxist-dominated swapo rebels	the most likely winner bed the marxist-dominated swapo rebels
messrs. lee and bynoe will manage the nuggets ' day-today affairs	messrs. lee and bynoe managed the nuggets ' day-today affairs
the stakes in the controversy are large	the stakes in the controversy were large
western digital does n't make the monitors	western digital did n't make the monitors
mr. freeman is an executive vice president of american express	mr. freeman was an executive vice president of american express
professional crisco products are specially made for the foodservice industry	professional crisco products were specially made for the foodservice industry
they always seem to come a bit later than you expect	they always seemed to come a bit later than you expected
mr. dozen knows these problems firsthand	mr. dozen knew these problems firsthand
a big pension-insurance case will be reviewed by the supreme court	a big pension-insurance case bed reviewed by the supreme court
compuserve provides about 20 % of both sales and earnings	compuserve provided about 20 % of both sales and earnings
small-lot buying targeted at incentive-backed issues pushed up the nikkei	small-lot buying targetted at incentive-backed issues pushed up the nikkei
so it 's a very mixed bag	so it was a very mixed bag
but put her behind a shopping cart and she turns ruthless	but put her behind a shopping cart and she turned ruthless
this is n't the quiet economic science practiced in the universities	this was n't the quiet economic science practiced in the universities
that indicates speculators are betting a higher offer is in the wings	that indicated speculators were betting a higher offer was in the wings
right away you notice the following things about a philip glass concert	right away you noticed the following things about a philip glass concert
texaco has purchased an oil-producing company in texas for 476.5 million	texaco had purchased an oil-producing company in texas for 476.5 million
now it 's dawning on them that they can be non-wealthy	now it was dawning on them that they could be non-wealthy
the bridge loans are intended to provide temporary financing for acquisitions	the bridge loans were intended to provide temporary financing for acquisitions
earnings have plummeted too in each of the past three quarters	earnings had plummeted too in each of the past three quarters
we did n't rubber-stamp everything that came to us mr. lynch says	we did n't rubber-stamp everything that came to us mr. lynch said
i 'm forever dumbfounded by what i see making these high prices	i was forever dumbfounded by what i saw making these high prices
this is an index fund with a bet	this was an index fund with a bet
but some investors and consultants who have tried it are enthusiastic	but some investors and consultants who had tried it were enthusiastic
real texans do n't play paddleball at least i hope not	real texans did n't play paddleball at least i hoped not
without legal recourse there are no guarantees of civil rights for anyone	without legal recourse there were no guarantees of civil rights for anyone
fear is the father of panic	fear was the father of panic
and that they say will be good for bonds	and that they said bed good for bonds
yet that has n't discouraged investors	yet that had n't discouraged investors
reinforcing such old building stock mr. johnson said comes down to money	reinforcing such old building stock mr. johnson said came down to money
strategy however is about possibilities not hopes and dreams	strategy however was about possibilities not hopes and dreams
on some days the nucor plant does n't produce anything	on some days the nucor plant did n't produce anything
one big obstacle is that few drugstores develop the film anymore	one big obstacle was that few drugstores developped the film anymore
mr. spinney is a permanent pentagon official	mr. spinney was a permanent pentagon official
mr. friend says his side is dead serious	mr. friend said his side was dead serious
things are beginning to settle down	things were beginning to settle down
drexel burnham lambert inc. is the adviser on the transaction	drexel burnham lambert inc. was the adviser on the transaction
but in this case the needle has a very sharp point	but in this case the needle had a very sharp point
nick cortese thinks that 's what happened to him	nick cortese thought that was what happened to him
but it has n't increased much relative to other assets	but it had n't increased much relative to other assets
the wind stinging with sand never seems to stop	the wind stinging with sand never seemed to stop
i 'm done in two minutes	i was done in two minutes
cairo 's spirited squalor also has gone gray	cairo 's spirited squalor also had gone gray
other temperature data show similar unexplained swings	other temperature data showed similar unexplained swings
meanwhile general motors and ford motor continue their pursuit of the company	meanwhile general motors and ford motor continued their pursuit of the company
sometimes as with batman the pair really do make the film	sometimes as with batman the pair really did make the film
he is president and chief executive officer of comerica inc. in detroit	he was president and chief executive officer of comerica inc. in detroit
mr. ohmae is managing director of mckinsey & co. in japan	mr. ohmae was managing director of mckinsey & co. in japan
reinsurance is protection taken out by the insurance firms themselves	reinsurance was protection took out by the insurance firms themselves
they do n't flinch at writing them	they did n't flinch at writing them
we do n't have passive readers	we did n't have passive readers
he joins nov. 13 dissolving his consulting firm canter achenbaum associates	he joined nov. 13 dissolving his consulting firm canter achenbaum associates
magazine publishers are facing spiraling costs and a glut of new titles	magazine publishers were facing spiraling costs and a glut of new titles
the new rate will be payable feb. 15	the new rate bed payable feb. 15
but not just any bonds will do	but not just any bonds did
some companies are starting to tackle that problem	some companies were starting to tackle that problem
two workers died and six remain in the hospital	two workers died and six remained in the hospital
but the agency has n't yanked psyllium off store shelves	but the agency had n't yanked psyllium off store shelves
cracking the top 10 within three years will be difficult at best	cracking the top 10 within three years bed difficult at best
the collateral is being sold by a thrift institution	the collateral was being sold by a thrift institution
that should help to inspire confidence mr. gilmore says	that should help to inspire confidence mr. gilmore said
now they 're losers and he 's in jail in mobile county	now they were losers and he was in jail in mobile county
paribas is allianz 's lead french bank	paribas was allianz 's lead french bank
the p53 gene has just been implicated in lung cancer	the p53 gene had just been implicated in lung cancer
the beginning was chaotic says nigel longley a broker for commerzbank	the beginning was chaotic said nigel longley a broker for commerzbank
the minimum coupon is 13 3\/4 %	the minimum coupon was 13 3\/4 %
gaf faces potential fines of 500,000 for each count	gaf faced potential fines of 500,000 for each count
campeau has too much debt	campeau had too much debt
we 're all a little greedy	we were all a little greedy
lloyd 's officials decline to comment on the matter	lloyd 's officials declined to comment on the matter
probably the most clear-cut soviet violation for example is the krasnoyarsk radar	probably the most clear-cut soviet violation for example was the krasnoyarsk radar
he remains chairman but wields little power at the company	he remained chairman but wields little power at the company
but in the process the fed risks reigniting inflation	but in the process the fed risked reigniting inflation
clients are all staying out of the market one merrill trader says	clients were all staying out of the market one merrill trader said
the companies in question believe the analysts are too pessimistic	the companies in question believed the analysts were too pessimistic
the solution to this problem is a time-limited poison pill	the solution to this problem was a time-limited poison pill
still the split is there	still the split was there
he remains chief executive officer	he remained chief executive officer
but they disagree about the message these settlements give to the public	but they disagreed about the message these settlements gave to the public
but they are also talking about new magazines	but they were also talking about new magazines
but it has only the fed to pursue price-level stability	but it had only the fed to pursue price-level stability
they value mccaw 's bid at 112 to 118 a share	they valued mccaw 's bid at 112 to 118 a share
the offering series 1989-85 is backed by fannie mae 9 % securities	the offering series 1989-85 was backed by fannie mae 9 % securities
it goes on to plug a few diversified fidelity funds by name	it went on to plug a few diversified fidelity funds by name
both companies are regional carriers in the southwest	both companies were regional carriers in the southwest
everyone in the world is watching us very closely	everyone in the world was watching us very closely
we see coal 's piece of the action growing mr. hutchinson said	we saw coal 's piece of the action growing mr. hutchinson said
mr. shiflett is an editorial writer for the rocky mountain news	mr. shiflett was an editorial writer for the rocky mountain news
minority recruiting has yet to meet hopes raised by bush administration	minority recruiting had yet to meet hopes raised by bush administration
he expects to invest the rest if the market weakens further	he expected to invest the rest if the market weakenned further
seats are quoted at 430,000 bid and 525,000 asked	seats were quoted at 430,000 bid and 525,000 asked
after all he says even to make love you need experience	after all he said even to make love you needed experience
estimated and actual results involving losses are omitted	estimated and actual results involving losses were omitted
for the moment at least euphoria has replaced anxiety on wall street	for the moment at least euphoria had replaced anxiety on wall street
ual corp. is a good example	ual corp. was a good example
for opec that 's ideal	for opec that was ideal
it is also planning another night of original series	it was also planning another night of original series
and the total amount of junk financing will be reduced	and the total amount of junk financing bed reduced
national environmental formerly yankee cos. is a sludge treatment company	national environmental formerly yankee cos. was a sludge treatment company
it is hoped that other japanese would then follow the leader	it was hoped that other japanese would then follow the leader
what did we get out of it	what did we got out of it
cri which sponsors champs is a world-wide real estate investment firm	cri which sponsored champs was a world-wide real estate investment firm
this is not a major crash she said	this was not a major crash she said
we are n't looking at anything like a doomsday scenario he says	we were n't looking at anything like a doomsday scenario he said
even if that scenario occurs westinghouse figures it is prepared	even if that scenario occured westinghouse figured it was prepared
some abortion advocates have been asking themselves this very question	some abortion advocates had been asking themselves this very question
that 's the dilemma for today 's parent	that was the dilemma for today 's parent
we 're not rushing into anything	we were not rushing into anything
the stars do that themselves	the stars did that themselves
everything 's a dollar operates 60 specialty-retail stores	everything 's a dollar operated 60 specialty-retail stores
this year some investors are changing their policies and investing a lot	this year some investors were changing their policies and investing a lot
but its unsentimental sketches of cairo life are vintage mahfouz	but its unsentimental sketches of cairo life were vintage mahfouz
and unlike ibm 's water-cooled mainframes it does n't need any plumbing	and unlike ibm 's water-cooled mainframes it did n't need any plumbing
currently the company has about six million common shares outstanding	currently the company had about six million common shares outstanding
i ca n't do anything score-wise but i like meeting the girls	i ca n't do anything score-wise but i liked meeting the girls
the suit sets the firms ' liability at more than 185 million	the suit set the firms ' liability at more than 185 million
no sophisticated professional expects economists to be right all the time	no sophisticated professional expected economists to be right all the time
would mr. antori ever get back in	would mr. antori ever got back in
it is shown weekdays on two of the country 's five networks	it was shown weekdays on two of the country 's five networks
the books 1,500 entries include stepping on cracks and knocking on wood	the books 1,500 entries included stepping on cracks and knocking on wood
some equipment going to work is almost new	some equipment going to worked was almost new
dsp makes electronic instrumentation and data acquisition systems	dsp made electronic instrumentation and data acquisition systems
under the program norfolk plans to acquire shares in the open market	under the program norfolk planned to acquire shares in the open market
we worry about her out there cynthia says	we worryed about her out there cynthia said
there 's unbelievable pressure on economists to forecast these numbers he says	there was unbelievable pressure on economists to forecast these numbers he said
we 're not rushing into anything	we were not rushing into anything
in recent days mr. krenz has sought to project a kinder image	in recent days mr. krenz had sought to project a kinder image
if there 's something weird and it do n't look good	if there was something weird and it did n't look good
why should anybody want to sell to them	why should anybody wanted to sell to them
the acquisition strengthens bsn 's position in the european pasta market	the acquisition strengthenned bsn 's position in the european pasta market
but sometimes more energetic attacks are required	but sometimes more energetic attacks were required
the service supplies weekly reports on school and college construction plans	the service supplyed weekly reports on school and college construction plans
the drug is being used primarily to treat anemias	the drug was being used primarily to treat anemias
3 decide whether you want a panel system or a single adjudicator	3 decided whether you wanted a panel system or a single adjudicator
shearson is about 60%-held by american express co	shearson was about 60%-held by american express co
the rest as they say is history	the rest as they said was history
the transaction is expected to close by nov. 30	the transaction was expected to close by nov. 30
but some money managers are doing just that	but some money managers were doing just that
litigation consulting is n't a guarantee of a favorable outcome	litigation consulting was n't a guarantee of a favorable outcome
for some players the lure is money up to 15,000 a month	for some players the lure was money up to 15,000 a month
i have felt many aftershocks	i had felt many aftershocks
there is n't a black worker in sight	there was n't a black worker in sight
about 1,150 employees are covered by the new agreement deere said	about 1,150 employees were covered by the new agreement deere said
this is n't a distress sale	this was n't a distress sale
i 'm now monitoring every major account	i was now monitoring every major account
in the year 2000 it will be one car per family	in the year 2000 it bed one car per family
mr. donohoo is scheduled to be sentenced dec. 11	mr. donohoo was scheduled to be sentenced dec. 11
city building codes require construction that can resist temblors	city building codes required construction that could resist temblors
there 's nothing rational about this kind of action	there was nothing rational about this kind of action
it sure smells like it he said	it sure smelt like it he said
a star attraction on the national network is the u.s. 's dynasty	a star attraction on the national network was the u.s. 's dynasty
mr. locke teaches english and comparative literature at columbia university	mr. locke taught english and comparative literature at columbia university
i see it as a sewage treatment plant he says	i saw it as a sewage treatment plant he said
we 're close to the bottom of the near-term ranges she contends	we were close to the bottom of the near-term ranges she contended
shearson lehman however executes program trades for clients	shearson lehman however executed program trades for clients
our commitment to manage these businesses profitably will continue	our commitment to manage these businesses profitably continued
it was our first acquisition he says and it was a mistake	it was our first acquisition he said and it was a mistake
i was upset with roger i fumpered and schmumpered says mr. peters	i was upset with roger i fumpered and schmumpered said mr. peters
the 6 3\/4 % notes yield 6.25 %	the 6 3\/4 % notes yielded 6.25 %
the new facility is expected to begin operations in early 1991	the new facility was expected to begin operations in early 1991
the pentagon has led the charge particularly as military alliances spread world-wide	the pentagon had led the charge particularly as military alliances spread world-wide
for the year however access lines in service have increased 5.5 %	for the year however access lines in service had increased 5.5 %
the orange workers are just putting this preaching into practice	the orange workers were just putting this preaching into practice
some people call me the communist billionaire she has told visitors	some people called me the communist billionaire she had told visitors
the house version of the bill does include the tax cut	the house version of the bill did include the tax cut
the line seems awfully thin for criminal-law purposes	the line seemed awfully thin for criminal-law purposes
mr. henning is a chicago-based law firm management consultant and a writer	mr. henning was a chicago-based law firm management consultant and a writer
we have one near here	we had one near here
that compares with 3.5 % butterfat for whole milk	that compared with 3.5 % butterfat for whole milk
and the poles are engaged in commerce	and the poles were engaged in commerce
they feel the need from time to time to educate me	they felt the need from time to time to educate me
its many lively stories include the gutfreund-postel holiday cheer imbroglio	its many lively stories included the gutfreund-postel holiday cheer imbroglio
my attitude is let 's come out of the closet	my attitude was let 's come out of the closet
but they will have to act quickly	but they had to act quickly
lloyd 's overblown bureaucracy also hampers efforts to update marketing strategies	lloyd 's overblown bureaucracy also hampered efforts to update marketing strategies
mr. trivelpiece 58 years old succeeds william bolger who died in august	mr. trivelpiece 58 years old succeeded william bolger who died in august
meanwhile overall evidence on the economy remains fairly clouded	meanwhile overall evidence on the economy remained fairly clouded
this is not the case	this was not the case
but you know about campaign promises	but you knew about campaign promises
so she thinks the damage will be short-lived and contained	so she thought the damage bed short-lived and contained
but five weeks after the premiere the series has floundered	but five weeks after the premiere the series had floundered
california thefts make travel agents jittery	california thefts made travel agents jittery
some in the industry are skeptical	some in the industry were skeptical
meanwhile at home mitsubishi has control of some major projects	meanwhile at home mitsubishi had control of some major projects
which cars do americans favor most these days	which cars do americans favored most these days
if they finish today the sharpshooter can pump tomorrow	if they finished today the sharpshooter could pump tomorrow
to many japanese pachinko is benign or enticingly unsavory	to many japanese pachinko was benign or enticingly unsavory
international business machines corp. also is expected to report disappointing results	international business machines corp. also was expected to report disappointing results
here in south texas we say tie-vole-ee my host gently corrects	here in south texas we said tie-vole-ee my host gently corrected
an investigation by u.s. postal inspectors is continuing	an investigation by u.s. postal inspectors was continuing
all of the bidders contemplate full payment including interest to secured creditors	all of the bidders contemplated full payment including interest to secured creditors
inflation is easier to spark and harder to control	inflation was easier to spark and harder to control
only it is safer and busier	only it was safer and busier
rising operating expenses are another problem	rising operating expenses were another problem
security costs are also quite high	security costs were also quite high
earnings have rebounded in 1989 after a 20 % decline last year	earnings had rebounded in 1989 after a 20 % decline last year
mandela considered the most prominent leader of the anc remains in prison	mandela considered the most prominent leader of the anc remained in prison
the computer 's miscalculation has been painful for renaissance	the computer 's miscalculation had been painful for renaissance
what accounts for the results of recent decades	what accounted for the results of recent decades
but it is clear he is going to give it a shot	but it was clear he was going to give it a shot
industry observers expect a wide divergence in performance	industry observers expected a wide divergence in performance
related roommates trim hospital bills	related roommates trimmed hospital bills
indeed the competition is n't greatly concerned	indeed the competition was n't greatly concerned
the cftc has 90 days to respond to such applications	the cftc had 90 days to respond to such applications
mr. ayers is editor and publisher of the anniston ala. star	mr. ayers was editor and publisher of the anniston ala. star
unfortunately they are in the minority	unfortunately they were in the minority
retailers are just in disarray	retailers were just in disarray
does the tyke have a good mind about to be wasted	does the tyke had a good mind about to be wasted
taken by surprise the socialist party is busy changing its doctrines	took by surprise the socialist party was busy changing its doctrines
it is a bureaucratic country	it was a bureaucratic country
conservatives expect bush to solidify their majority on a key court	conservatives expected bush to solidify their majority on a key court
details about its size and cost have n't yet been determined	details about its size and cost had n't yet been determined
for the government it has become a highly volatile political issue	for the government it had become a highly volatile political issue
what did he think of the supreme court 's decision legalizing abortion	what did he thought of the supreme court 's decision legalizing abortion
at this point the truce between feminism and sensationalism gets mighty uneasy	at this point the truce between feminism and sensationalism got mighty uneasy
miss brady is deputy director of the russian research foundation in london	miss brady was deputy director of the russian research foundation in london
the average yield there on six-month issues is 8.32 %	the average yield there on six-month issues was 8.32 %
a pair of black skimmers zig-zag past close to the surface	a pair of black skimmers zig-zagged past close to the surface
management co. manages entertainers and produces markets and finances entertainment	management co. managed entertainers and produces markets and finances entertainment
this is a democratic process you ca n't slam-dunk anything around here	this was a democratic process you ca n't slam-dunk anything around here
it 's a real face-to-face arm wrestling challenge to congress	it was a real face-to-face arm wrestling challenge to congress
b.a.t has declined to identify the potential bidders	b.a.t had declined to identify the potential bidders
but these are not the differences that make headlines	but these were not the differences that made headlines
any hiring is confined to retail sales	any hiring was confined to retail sales
nope we still say to stick with treasurys mr. corcoran replies	nope we still said to stick with treasurys mr. corcoran replyed
this is a very tenacious ghost mr. warren says darkly	this was a very tenacious ghost mr. warren said darkly
had the case gone to trial the same issues would have surfaced	had the case went to trial the same issues would have surfaced
a revolution takes more than conference manifestos	a revolution took more than conference manifestos
many economists have started predicting a mild recession next year	many economists had started predicting a mild recession next year
with notes they 're visually distinct	with notes they were visually distinct
i 'm going to ship and hope i get paid	i was going to shipped and hope i got paid
working with lawyers she says i need it	working with lawyers she said i needed it
the company also faces delisting by the national association of securities dealers	the company also faced delisting by the national association of securities dealers
i am determined to get an apartment in three years she says	i was determined to get an apartment in three years she said
every broker has blocks of every size and maturity	every broker had blocks of every size and maturity
now movieline is located in the same building as vesoft	now movieline was located in the same building as vesoft
to be sure the stock still has a lot of fans	to be sure the stock still had a lot of fans
it 's sort of loyalty by default	it was sort of loyalty by default
there is hope of change	there was hope of change
designs call for an l-shaped structure with a playground in the center	designs called for an l-shaped structure with a playground in the center
the metal products concern currently has 7.2 million common shares outstanding	the metal products concern currently had 7.2 million common shares outstanding
but some militant sci tv junk-holders say that 's not enough	but some militant sci tv junk-holders said that was not enough
we are almost left out of campus social activities	we were almost left out of campus social activities
mrs. marcos 's trial is expected to begin in march	mrs. marcos 's trial was expected to begin in march
what you have here is intuition made manifest	what you had here was intuition made manifest
already the fight has been costly	already the fight had been costly
this case realizes that concern	this case realized that concern
first its position in the government is anomalous	first its position in the government was anomalous
i do n't think the checks are worth 15 apiece he says	i did n't think the checks were worth 15 apiece he said
copper has been stuck in a trading range of 1.19 to 1.34	copper had been stuck in a trading range of 1.19 to 1.34
we have a major problem and that problem is volatility	we had a major problem and that problem was volatility
the capital market is booming	the capital market was booming
that 's the only question we need to address	that was the only question we needed to address
which types of stocks currently have the greatest earnings risks	which types of stocks currently had the greatest earnings risks
marginal operations and assets have been sold	marginal operations and assets had been sold
montedison now owns about 72 % of erbamont 's shares outstanding	montedison now owned about 72 % of erbamont 's shares outstanding
mcdonald 's has also been running negative all year the analyst says	mcdonald 's had also been running negative all year the analyst said
fannie mae makes a secondary market in home loans	fannie mae made a secondary market in home loans
mr. engelken says his wife was overwhelmed by the whole thing	mr. engelken said his wife was overwhelmed by the whole thing
beverly hills comes to suburban tokyo	beverly hills came to suburban tokyo
you do n't want to own anything long except gold stocks	you did n't want to own anything long except gold stocks
they 're deliberately trying to steal our thunder a digital executive complains	they were deliberately trying to steal our thunder a digital executive complained
he now calls himself an investment banker	he now called himself an investment banker
if i can show signs of maturity almost anybody can he jokes	if i could show signs of maturity almost anybody could he joked
in general they say avoid takeover stocks	in general they said avoided takeover stocks
its plan is set up as an independent agency	its plan was set up as an independent agency
ferruzzi has denied it was trying to manipulate the soybean futures market	ferruzzi had denied it was trying to manipulate the soybean futures market
every major maker offers computers with color displays	every major maker offered computers with color displays
mellon has 36.6 million shares outstanding	mellon had 36.6 million shares outstanding
because of the vagaries of gramm-rudman the immediate impact is relatively small	because of the vagaries of gramm-rudman the immediate impact was relatively small
frank mingo dies at 49	frank mingo died at 49
he succeeds alvin a. mccall in the position	he succeeded alvin a. mccall in the position
mr. gelbart also has fun with language	mr. gelbart also had fun with language
a similar provision is in the house version	a similar provision was in the house version
our expectation of confidentiality is being eroded	our expectation of confidentiality was being eroded
some maintain underwriters also have been inept	some maintained underwriters also had been inept
the cuts will be made half within germany and half abroad	the cuts bed made half within germany and half abroad
there are die-hard bodies of course	there were die-hard bodies of course
the company can go about its business	the company could go about its business
so we did it over he adds	so we did it over he added
okay now you can pick up that phone	okay now you could pick up that phone
all this is causing convulsions in professional football	all this was causing convulsions in professional football
but other figures are surprising	but other figures were surprising
you can think long range	you could think long range
cbs is likely to spend whatever it takes to keep them	cbs was likely to spend whatever it took to keep them
solar-powered batteries will make the spire glow	solar-powered batteries made the spire glow
felix siemienas is destroying it now	felix siemienas was destroying it now
a policeman shakes his head in amazement as he steers them away	a policeman shook his head in amazement as he steered them away
in post-earthquake parlance her building is a red	in post-earthquake parlance her building was a red
beefeater alone is worth as much as 300 million analysts said	beefeater alone was worth as much as 300 million analysts said
mr. sheinberg remains as executive vice president	mr. sheinberg remained as executive vice president
apparently their verdict is in	apparently their verdict was in
kate 's ma louise latham is a moral coward	kate 's ma louise latham was a moral coward
that will spur tandem 's growth	that spured tandem 's growth
no foreign companies bid on the hiroshima project according to the bureau	no foreign companies bidded on the hiroshima project according to the bureau
but most lawyers accept that the marketplace has spoken	but most lawyers accepted that the marketplace had spoken
if they do good credit analysis they will avoid the hand grenades	if they did good credit analysis they avoided the hand grenades
the executive branch bears the first responsibility for timidity	the executive branch bore the first responsibility for timidity
that 's always looking back she said	that was always looking back she said
in that case there will be plenty of blame to go around	in that case there was plenty of blame to go around
the condition known as paroxysmal supraventricular tachycardia leads to dizziness and fainting	the condition knew as paroxysmal supraventricular tachycardia led to dizziness and fainting
the party is fed up with sackings of good people	the party was fed up with sackings of good people
longer term the impact is unclear	longer term the impact was unclear
i do n't think anyone left the place whistling dixie	i did n't think anyone left the place whistling dixie
management and labor worry that the gap makes u.s. companies less competitive	management and labor worryed that the gap made u.s. companies less competitive
imelda marcos asks for dismissal says she was kidnapped	imelda marcos asked for dismissal says she was kidnapped
their yields are higher than those of u.s. treasury issues	their yields were higher than those of u.s. treasury issues
these bacterial cousins ordinarily do n't make the toxin	these bacterial cousins ordinarily did n't make the toxin
poland 's premier is to visit moscow next month	poland 's premier was to visit moscow next month
you never know where she 'll turn up	you never knew where she 'll turn up
the farmer can say the same for coal cement saw blades	the farmer could say the same for coal cement saw blades
which is the best medicine for runaway health costs competition or regulation	which bed the best medicine for runaway health costs competition or regulation
but yesterday 's announcement indicates that ford has n't lost interest	but yesterday 's announcement indicated that ford had n't lost interest
sometimes traders lose sight of that he says	sometimes traders lost sight of that he said
we 're just seeing the beginning of a shift mr. smith says	we were just seeing the beginning of a shift mr. smith said
judges oakes and leval understand the requirements of historical scholarship	judges oakes and leval understood the requirements of historical scholarship
tangible capital will be about 115 million	tangible capital bed about 115 million
mr. allday 's appointment is subject to confirmation by the senate	mr. allday 's appointment was subject to confirmation by the senate
learning aids lists films pamphlets brochures videos and other educational data	learning aids listed films pamphlets brochures videos and other educational data
this reduces the baseline by 229 billion	this reduced the baseline by 229 billion
the irs hopes to fill the new positions soon	the irs hopped to fill the new positions soon
many fund managers argue that now 's the time to buy	many fund managers argued that now was the time to buy
such centrifugal egg breakers have been around since the 1890s	such centrifugal egg breakers had been around since the 1890s
the fundamentals are pretty strong mr. dreman says	the fundamentals were pretty strong mr. dreman said
however we are n't currently doing anything	however we were n't currently doing anything
the khmer rouge however carry an unsurpassed record for cambodian tyranny	the khmer rouge however carryed an unsurpassed record for cambodian tyranny
the lawyers are now in charge of our national security	the lawyers were now in charge of our national security
once again the indomitable peasant holds poland 's future in his hands	once again the indomitable peasant held poland 's future in his hands
so far the mega-issues are a hit with investors	so far the mega-issues were a hit with investors
tymnet is a major network linking computers	tymnet was a major network linking computers
some 70 % of them are to be exported to the u.s.	some 70 % of them were to be exported to the u.s.
spiegel is 84%-controlled by the otto family of west germany	spiegel was 84%-controlled by the otto family of west germany
television news of course has always been part show-biz	television news of course had always been part show-biz
clearly the judge has had his share of accomplishments	clearly the judge had had his share of accomplishments
the law sets a deficit target of 100 billion for fiscal 1990	the law set a deficit target of 100 billion for fiscal 1990
it falls to others to do the writing directing and producing	it fell to others to do the writing directing and producing
as this is now a litigation matter we have no further comment	as this was now a litigation matter we had no further comment
mr. siemienas is making a fortune 10,000 a month he says	mr. siemienas was making a fortune 10,000 a month he said
it 's very revealing and soul baring said ms. volokh	it was very revealing and soul baring said ms. volokh
many investors certainly believe a bidding war is imminent	many investors certainly believed a bidding war was imminent
anti-abortion forces regard him as at best an uncertain ally	anti-abortion forces regarded him as at best an uncertain ally
a.g. edwards & sons runs training classes and looks for experienced brokers	a.g. edwards & sons ran training classes and looks for experienced brokers
each share point is worth about 60 million in sales	each share point was worth about 60 million in sales
second-tier companies are receiving even less per ton	second-tier companies were receiving even less per ton
the percentage change is since year-end	the percentage change was since year-end
increasingly the financial markets are reflecting the gloom	increasingly the financial markets were reflecting the gloom
casino revenues and hotel occupancy rates are high	casino revenues and hotel occupancy rates were high
in japan small suggestions are encouraged	in japan small suggestions were encouraged
the summer crop is harvested winter sowing has yet to begin	the summer crop was harvested winter sowing had yet to begin
there is no justification on the fundamental level for this crash	there was no justification on the fundamental level for this crash
the yale political union does n't pay an honorarium to speakers	the yale political union did n't pay an honorarium to speakers
thank goodness it 's happening	thanked goodness it was happening
manville itself does n't rule out a restructuring	manville itself did n't rule out a restructuring
the takeover mania also adds to volatility	the takeover mania also added to volatility
and the winners will be the colleges not either network	and the winners bed the colleges not either network
state loan guarantees are rarely a source of controversy	state loan guarantees were rarely a source of controversy
the union is continuing to work through its expired contract however	the union was continuing to work through its expired contract however
he confers big trading commissions on wall street firms	he confered big trading commissions on wall street firms
i believe that number reflects a slowing economy	i believed that number reflected a slowing economy
if that happens chairman greenspan could well become an open target	if that happenned chairman greenspan could well become an open target
to leave this decision to an independent agency is not only undemocratic	to leave this decision to an independent agency was not only undemocratic
ms. bogart 's cast is part and parcel of the problem	ms. bogart 's cast was part and parcel of the problem
a reintegrated europe implies big changes in 40-year-old military and economic policies	a reintegrated europe implyed big changes in 40-year-old military and economic policies
batibot lacks the polish of sesame street	batibot lacked the polish of sesame street
mr. padovan is currently a director at barclays de zoete wedd ltd	mr. padovan was currently a director at barclays de zoete wedd ltd
their machine tools are even bolted to the shop floor	their machine tools were even bolted to the shop floor
the phillips plant makes polyethylene polypropylene and other plastic products	the phillips plant made polyethylene polypropylene and other plastic products
the action renews concern about buyouts in high-tech industries	the action renewed concern about buyouts in high-tech industries
it 's doubtful though whether circuit breakers do any real good	it was doubtful though whether circuit breakers did any real good
chicago law firm recruits american express co. vice president	chicago law firm recruited american express co. vice president
the issue includes 100 million of insured senior lien bonds	the issue included 100 million of insured senior lien bonds
i think you have to give greenspan a good rating	i thought you had to give greenspan a good rating
hewlett-packard is based in palo alto calif	hewlett-packard was based in palo alto calif
chip 's memory is here today here tomorrow	chip 's memory bed here today here tomorrow
the beebes have not yet decided whether to appeal	the beebes had not yet decided whether to appeal
what you then do is you make them think inappropriately	what you then did was you made them thought inappropriately
today there are 77 units all located in shopping malls	today there were 77 units all located in shopping malls
the secretary is the world 's biggest borrower of money	the secretary was the world 's biggest borrower of money
these are not certain either	these were not certain either
japan 's markets are more stable he said	japan 's markets were more stable he said
the company estimates its total debt at about 5.2 billion	the company estimated its total debt at about 5.2 billion
digital is promising a new approach	digital was promising a new approach
nowhere have eyes been opened wider than at cbs news	nowhere have eyes bed opened wider than at cbs news
why ca n't we teach our children to read write and reckon	why ca n't we taught our children to read write and reckon
i refer essentially to petroleum electric power banking and newsprint	i refered essentially to petroleum electric power banking and newsprint
companies that only recently were thriving find themselves scrambling to survive	companies that only recently were thriving found themselves scrambling to survive
but friday did n't help things says mr. schaefer	but friday did n't help things said mr. schaefer
that 's good news because we all swim in this water	that was good news because we all swam in this water
the truth is washington understands politics better than economics	the truth was washington understands politics better than economics
the unit has 30 employees in four california offices the company said	the unit had 30 employees in four california offices the company said
the bonds are insured and rated triple-a by moody 's and s&p	the bonds were insured and rated triple-a by moody 's and s&p
hand-holding is becoming an investment-banking job requirement	hand-holding was becoming an investment-banking job requirement
they want to do more	they wanted to do more
a 60-day to 65-day supply is considered normal	a 60-day to 65-day supply was considered normal
but he is n't worried	but he was n't worried
the state can also bar drexel as an investment adviser	the state could also bar drexel as an investment adviser
among the leading products is a flu shot for horses	among the leading products was a flu shot for horses
he has mastered the art of survival	he had mastered the art of survival
mr. baker promises to return if the haunting continues	mr. baker promised to return if the haunting continued
the company is exposed to bulk chemicals however	the company was exposed to bulk chemicals however
indeed his caution has become legendary within the government	indeed his caution had become legendary within the government
the ventilation here is great	the ventilation here was great
but this raises added cost barriers to urban entrepreneurship	but this raised added cost barriers to urban entrepreneurship
foreign traders say the company is strapped for cash	foreign traders said the company was strapped for cash
but the broader truth is more complicated and dismaying	but the broader truth was more complicated and dismaying
and when they lose then we can expect china to stop aid	and when they lost then we could expect china to stop aid
that amounts to more than 350 billion a year	that amounted to more than 350 billion a year
behind the silly posturing lies a real dispute	behind the silly posturing lied a real dispute
we have a couple or three tough weeks coming	we had a couple or three tough weeks coming
ford faces an uphill fight for jaguar however	ford faced an uphill fight for jaguar however
oddly enough this presents a problem for the stock	oddly enough this presented a problem for the stock
the stores they work for may be sold	the stores they worked for may be sold
but the apple industry is ripe for change	but the apple industry was ripe for change
that 's about half the price of comparably equipped ibm mainframes	that was about half the price of comparably equipped ibm mainframes
the big one is still due mr. johnson predicted in an interview	the big one was still due mr. johnson predicted in an interview
this interest in words goes beyond puns and playfulness however	this interest in words went beyond puns and playfulness however
cathay officials decline to comment on the speculation	cathay officials declined to comment on the speculation
ag is hardly alone in its anxiety	ag was hardly alone in its anxiety
u.k. base rates are at their highest level in eight years	u.k. base rates were at their highest level in eight years
but quite a few money managers are n't buying it	but quite a few money managers were n't buying it
should the rest of the series be played at all	should the rest of the series bed played at all
but critics fret that post-1997 officials ultimately will be responsible to beijing	but critics fretted that post-1997 officials ultimately bed responsible to beijing
this whole experience has been an opportunity for internal growth he says	this whole experience had been an opportunity for internal growth he said
we consumers tend to have long memories	we consumers tended to have long memories
venezuela will hold a debt-equity auction friday with 32 potential bidders participating	venezuela held a debt-equity auction friday with 32 potential bidders participating
unless the questions are answered i will keep on going	unless the questions were answered i kept on going
once they size them up then they know what buttons to push	once they sized them up then they knew what buttons to push
we are seeing such exercises today in fact	we were seeing such exercises today in fact
that 's antithetical to the art of selling	that was antithetical to the art of selling
mr. gale is an assistant professor of economics at ucla	mr. gale was an assistant professor of economics at ucla
the future of the forest remains uncertain	the future of the forest remained uncertain
another challenges merrill lynch 's bond recommendation last year	another challenged merrill lynch 's bond recommendation last year
1 make sure you have a strong personnel department	1 made sure you had a strong personnel department
all the numbers are adjusted for seasonal fluctuations	all the numbers were adjusted for seasonal fluctuations
major european auction houses are turning increasingly to specialized sales	major european auction houses were turning increasingly to specialized sales
letting officials express their own nuances can be educational	letting officials expressed their own nuances could be educational
it 's worse than i thought she said	it was worse than i thought she said
the finger-pointing has already begun	the finger-pointing had already begun
the company also makes optical character recognition equipment	the company also made optical character recognition equipment
nevertheless the device has been successful in other ways	nevertheless the device had been successful in other ways
its contract expires dec. 1	its contract expired dec. 1
there are better ways to promote a cause	there were better ways to promote a cause
this means the returns can vary a great deal	this meant the returns could vary a great deal
but much will depend on how quickly ibm can move	but much depended on how quickly ibm could move
most bills are drafted by bureaucrats not politicians	most bills were drafted by bureaucrats not politicians
the changes have n't come easy	the changes had n't come easy
they do n't want to get caught again says one industry watcher	they did n't want to get caught again said one industry watcher
the current backlog of orders is strong throughout the corporation he said	the current backlog of orders was strong throughout the corporation he said
so does mr. friend and his law partner nick nichols	so did mr. friend and his law partner nick nichols
people will learn to be more circumspect	people learned to be more circumspect
he is n't as well-known to clients as is mr. roman	he was n't as well-known to clients as was mr. roman
so he advises make goals achievable	so he advised made goals achievable
now you see it now you do n't	now you saw it now you did n't
new york city bonds have been beaten down for three straight weeks	new york city bonds had been beaten down for three straight weeks
the second portion will be completed the following year	the second portion bed completed the following year
since then prices have slumped to an average of 395,374 this summer	since then prices had slumped to an average of 395,374 this summer
consider the facts underlying the 1989 conviction of robert chestman	considered the facts underlying the 1989 conviction of robert chestman
we 're just recovering and getting back to business as usual	we were just recovering and getting back to business as usual
mr. boren even spies a silver lining	mr. boren even spied a silver lining
serial bonds are priced to yield to 7 % in 1999	serial bonds were priced to yield to 7 % in 1999
that 's 115 % more than in 1981	that was 115 % more than in 1981
now there have been a number of questions raised	now there had been a number of questions raised
mr. lang feels that time 's priorities changed	mr. lang felt that time 's priorities changed
a main motive is hard cash	a main motive was hard cash
the ads celebrate the achievements of some of lake view 's residents	the ads celebrated the achievements of some of lake view 's residents
calisto tanzi odeon 's owner will retain his 23.34 % stake	calisto tanzi odeon 's owner retained his 23.34 % stake
new york life has been doing the same for over 140 years	new york life had been doing the same for over 140 years
the bonds are all rated single-a by moody 's investors service inc	the bonds were all rated single-a by moody 's investors service inc
and truck sales also are off more than 20 %	and truck sales also were off more than 20 %
periodically there are threats that the program will fold	periodically there were threats that the program folded
each rothschild bank is linked by family ties and cross-ownership	each rothschild bank was linked by family ties and cross-ownership
