the financial times 30-share index closed 79.3 points lower at 1738.7	the financial times 30-share index closed 79.3 points lower
terms of the transaction were n't disclosed	terms were n't disclosed
buyers stepped in to the futures pit	buyers stepped in
the transaction is expected to close by nov. 30	the transaction is expected to close
the offering series 1989-86 is backed by fannie mae 9 % securities	the offering series 1989-86 is backed
currently average pay for machinists is 13.39 an hour boeing said	currently average pay is 13.39 an hour boeing said
sun also reported a record backlog of orders	sun also reported a record backlog
this being typed in a standing position	this being typed
after years of fading into the background two-tone photography is coming back	two-tone photography is coming back
heiwa real estate gained 40 to 2210	heiwa real estate gained 40
consumer stocks once again set the pace for blue-chip issues	consumer stocks once again set the pace
interest rates barely budged from tuesday 's levels	interest rates barely budged
hilton lost 20 % on friday paramount lost almost 11 %	hilton lost 20 % paramount lost almost 11 %
prices of treasury bonds tumbled in moderate to active trading	prices tumbled
by contrast surgical abortion is 99 % effective	surgical abortion is 99 % effective
some 70 % of them are to be exported to the u.s.	some 70 % are to be exported
this action was defended by the canadian government on conservation grounds	this action was defended
mr. mehl attributed the rise specifically to the treasury bill increase	mr. mehl attributed the rise
of course many more issues 93 hit new lows	many more issues 93 hit new lows
it was crazy said neil weisman general partner of chilmark capital corp	it was crazy said neil weisman general partner
productivity in japanese offices is relatively low	productivity is relatively low
waxman sells a variety of hardware products for the home repair market	waxman sells a variety
you 're making a pure bet on the market	you 're making a pure bet
most estimates for monsanto run between 1.70 and 2 a share	most estimates run
but there 's another side to mr. krenz	but there 's another side
volume on the new york stock exchange totaled 155.7 million shares	volume totaled 155.7 million shares
but there is a grimly ironic twist to the columbia loss	but there is a grimly ironic twist
gerald f. seib contributed to this article	gerald f. seib contributed
in september kellogg co. launched a competing psyllium-fortified cereal called heartwise	kellogg co. launched a competing psyllium-fortified cereal called heartwise
farm income is 15 % below the average	farm income is
the two big banks were instrumental in designing the new contract	the two big banks were instrumental
they are piggybacking onto developed technology he said	they are piggybacking he said
but middle east supplies were growing in importance	but middle east supplies were growing
he was back in jail over the summer on shoplifting charges	he was back
on china 's turmoil it is a very unhappy scene he said	it is a very unhappy scene he said
now television and radio evangelists are under scrutiny	now television and radio evangelists are
revenue rose to 235.2 million from 176.4 million	revenue rose
here 's a look at some of the alternatives	here 's a look
the drug was introduced in west germany this year	the drug was introduced this year
bush and gorbachev will hold two days of informal talks next month	bush and gorbachev will hold two days next month
they are all priced at par	they are all priced
the company reported a big third-quarter loss on thursday	the company reported a big third-quarter loss
and the sets are wider resembling the dimensions of a movie screen	and the sets are wider resembling the dimensions
it earned 76.4 million or 1.82 a share in the 1988 quarter	it earned 76.4 million or 1.82 a share
borrowed shares on the amex rose to another record	borrowed shares rose
added mr. jacobson there were some pretty bad losses in the stock	added mr. jacobson there were some pretty bad losses
once and for all 5-a-barrel crude oil and 35-cents-a-gallon gasoline were history	once and 5-a-barrel crude oil and 35-cents-a-gallon gasoline were history
reinsurance is protection taken out by the insurance firms themselves	reinsurance is protection taken out
rather they tend to have a set of two or three favorites	rather they tend to have a set
shares of biotechnology companies in the area were also higher	shares were also higher
it had a 258.9 million loss in the second quarter	it had a 258.9 million loss
changing the outcome of the trial is what really matters	changing the outcome is what really matters
big business mr. pawlowski snorts in english	big business mr. pawlowski snorts
federal judge expands role of u.s. courts in extradition decisions	federal judge expands role
its interest expense surged to 21.5 million from 12.4 million	its interest expense surged
revenue rose 15 % to 2.17 billion from 1.89 billion	revenue rose 15 %
the senators responded in kind	the senators responded
by lunchtime the selling was at near-panic fever	the selling was
the acquisition was completed in september	the acquisition was completed
he said he would convene hearings within two weeks	he said he would convene hearings
some current rates exceed those on cds	some current rates exceed those
short-term interest rates rose at the government 's regular weekly treasury-bill auction	short-term interest rates rose
in 1987 prosecutors filed against 35 defendants for every 100,000 adults	prosecutors filed
the price movements get bigger as the maturity of the securities lengthens	the price movements get bigger as the maturity lengthens
the loss was largely due to a 55.2 million addition to reserves	the loss was largely due
a spokeswoman for paramount said the company does n't comment on speculation	a spokeswoman said the company does n't comment
the agency plans to announce specific relief procedures in the coming days	the agency plans to announce specific relief procedures
but violation could bring substantial tax penalties to both employer and employees	but violation could bring substantial tax penalties
americans stay longer with japanese firms than american companies	americans stay longer
the country 's narcotics traffickers claimed responsibility for the slaying	the country 's narcotics traffickers claimed responsibility
the financial times 30-share index settled 27.8 points higher at 1758.5	the financial times 30-share index settled 27.8 points higher
i was never a rebel he said in an earlier interview	i was never a rebel he said
the increase was spread fairly evenly among all three types of funds	the increase was spread fairly evenly
on isaac stern 's recording it 's very biting	it 's very biting
they gleefully await the dream season in 1990	they gleefully await the dream season
the state will vigorously defend against any counterclaim	the state will vigorously defend
two other men also were charged with participating in the operation	two other men also were charged
but general motors dropped 1 7\/8 to 44 7\/8	but general motors dropped 1 7\/8
that target has been revised to 30 % by the year 2000	that target has been revised
some members of the huge crowd shouted viva peace viva	some members shouted viva peace viva
earnings per share were 10.35 kronor compared with 5.80 kronor	earnings were 10.35 kronor
for several months there was optimism all around	there was optimism all around
in the experiment mice with the defective gene were mated	mice were mated
it takes three months to turn copper concentrate into cathodes he said	it takes three months to turn copper concentrate he said
october is a critical month for the privatization program	october is a critical month
james a. white and sonja steptoe contributed to this article	james a. white and sonja steptoe contributed
creation of a new realistic u.s. policy is long overdue	creation is long overdue
he says he has never even dined with gangsters	he says he has never even dined
tenneco credit is a unit of tenneco inc	tenneco credit is a unit
in congress lawmakers already are looking for ways to add relief funds	lawmakers already are looking
kidder officials stand by their aggressive use of program trading	kidder officials stand
the condition known as paroxysmal supraventricular tachycardia leads to dizziness and fainting	the condition known leads
mr. nolan is a contributing editor at los angeles magazine	mr. nolan is a contributing editor
it would have been too late to think about on friday	it would have been too late to think
statistics canada said service-industry output in august rose 0.4 % from july	statistics canada said service-industry output rose 0.4 %
a saatchi spokesman declined to comment about interpublic	a saatchi spokesman declined to comment
nine-month revenue was 1.02 billion up 22 % from 841.5 million	nine-month revenue was 1.02 billion up 22 %
why in these movies is the unwed pregnant woman always from ohio	why is the unwed pregnant woman always
portrait studios have also latched onto the trend	portrait studios have also latched
municipal bonds were little changed to 1\/2 point higher in late dealings	municipal bonds were little changed
he wants to see steelmakers more involved in computers and artificial intelligence	he wants to see steelmakers more involved
overall salomon reported program trading volume of 75.2 million shares	overall salomon reported program trading volume
meanwhile new-home sales plunged 14 % in the month	meanwhile new-home sales plunged 14 %
they attached a second gene for herbicide resistance to the pollen-inhibiting gene	they attached a second gene
the clean water act contains no legal standard of zero discharge	the clean water act contains no legal standard
foreign bonds surged as the dollar weakened against most major currencies	foreign bonds surged as the dollar weakened
he also repeated justin 's denial of sony 's charges	he also repeated justin 's denial
transcanada declined to comment on the foothills application	transcanada declined to comment
only 22 % supported private security patrols funded by the merchants themselves	only 22 % supported private security patrols funded
rmi titanium is owned jointly by usx and quantum chemical corp	rmi titanium is owned jointly
this is a story about suckers	this is a story
as previously reported helionetics emerged from chapter 11 bankruptcy-law protection in february	as previously reported helionetics emerged
he could grasp an issue with the blink of an eye	he could grasp an issue
a healthy embryo can be picked for implantation and defective ones discarded	a healthy embryo can be picked and defective ones discarded
that 's just what happened in the october 1987 crash	that 's just what happened
but the brand had trouble from the start	but the brand had trouble
retailers could get a boost this year from the calendar	retailers could get a boost this year
the 142 institutional-type money funds rose 2.23 billion to 85.49 billion	the 142 institutional-type money funds rose 2.23 billion
the solution is stronger domestic growth in germany he said	the solution is stronger domestic growth he said
the company develops and markets products for the food service industry	the company develops and markets products
we still think there 's a lot of unsettlement in this market	we still think there 's a lot
the spinoff should solve a problem for the parent	the spinoff should solve a problem
the figures are at seasonally adjusted annual rates in trillions of dollars	the figures are
friday brings the final count on october auto sales	friday brings the final count
many of the affluent are n't comfortable with themselves either	many are n't comfortable either
ntt lost 30,000 yen to 1,380,000 yen 9,756	ntt lost 30,000 yen
not everything looks grim for quantum	not everything looks grim
taxes are not going out of business	taxes are not going out
and there were senate hearings on the questions in july 1972	and there were senate hearings
everyone in the world is watching us very closely	everyone is watching us very closely
the i-880 section had completed the first phase of the retrofitting	the i-880 section had completed the first phase
it is a distinction that satisfies neither side in the debate	it is a distinction that satisfies neither side
in montreal exchange trading memotec closed unchanged at 10.625 canadian dollars 9.05	memotec closed unchanged
the 30-share index fell 33.3 points to 1739.3	the 30-share index fell 33.3 points
ibm is based in armonk n.y	ibm is based
some state middlemen come to buy from me	some state middlemen come to buy
for them it makes all kinds of sense	it makes all kinds
senator pete domenici calls this effort the first gift of democracy	senator pete domenici calls this effort the first gift
he adds i think this is a great strategic move for quebecor	he adds i think this is a great strategic move
and most of these are absolutely unnecessary	and most are absolutely unnecessary
i assumed i was buying a cd as a cd he says	i assumed i was buying a cd he says
second section volume was estimated at 14 million shares unchanged from monday	second section volume was estimated unchanged
i am ready at any moment to compete with a state farm	i am ready to compete
that loss compared with a year-earlier profit of 273.5 million	that loss compared
some of the oil interests already have been sold	some already have been sold
mr. kakita said the key dollar-yen exchange rate is at 135 yen	mr. kakita said the key dollar-yen exchange rate is
eagle 's plastic type sharpens and looks like a wooden pencil	eagle 's plastic type sharpens and looks
even so few had ever dealt with an earthquake	even so few had ever dealt
aftershocks rattled northern california amid an earthquake cleanup	aftershocks rattled northern california
the work force provides the third arm of the alliance	the work force provides the third arm
more important the cd was purchased on the secondary or resale market	more important the cd was purchased
the sales recovery screeched to a halt this month some analysts say	the sales recovery screeched this month some analysts say
but new york city general obligation bonds came under selling pressure	but new york city general obligation bonds came
it 's a nuisance tax on mergers	it 's a nuisance tax
the only time the violin has it is right at the end	the only time the violin has it is
the owner was israel ortiz a 29-year-old entrepreneur and father of two	the owner was israel ortiz a 29-year-old entrepreneur and father
but they attribute much of the weakness to customer inventory reductions	but they attribute much
today there are 77 units all located in shopping malls	today there are 77 units all located
lawyers for the garcias said they plan to appeal	lawyers said they plan to appeal
everybody was still confident including most institutional investors	everybody was still confident
they saw an opportunity created by the sell-off	they saw an opportunity created
the dividend is payable dec. 15 to stock of record nov. 15	the dividend is payable dec. 15
having donated heavily to museums they demand a place on their boards	having donated heavily they demand a place
at gmac net dropped 3.1 % to 234.5 million from 241.9 million	net dropped 3.1 %
some of the large amounts are being raised by small firms	some are being raised
it was downhill from there however	it was downhill however
announced and anticipated purchases from foreign countries are also supporting futures prices	announced and anticipated purchases are also supporting futures prices
if there 's somethin' strange in your neighborhood	if there 's somethin' strange
in the year-earlier quarter the tax credit was 3.3 million	the tax credit was 3.3 million
this could be the first major bankruptcy-law proceeding for kkr he adds	this could be the first major bankruptcy-law proceeding he adds
but with some clients the talk can heat up a bit	but the talk can heat up a bit
today mr. corry presides over a company whose fortunes have changed abruptly	today mr. corry presides
but such skills were alien to toni johnson	but such skills were alien
the board increased by one to 26 members	the board increased
pharmaceuticals were mostly higher with ss pharmaceutical gaining 140 to 1,980	pharmaceuticals were mostly higher
the financial times 100-share index finished 10.6 points higher at 2189.7	the financial times 100-share index finished 10.6 points higher
there are of course obvious dangers to blatant unsubstantiated name-dropping	there are obvious dangers
that indicates speculators are betting a higher offer is in the wings	that indicates speculators are betting a higher offer is
a surprisingly small amount of reserves was added to the banking system	a surprisingly small amount was added
revenues declined 1 % to 4.17 billion from 4.19 billion	revenues declined 1 %
the last six months has established the quality of the collection	the last six months has established the quality
no one else will watch out for you	no one else will watch out
in greater israel more than half the children under six are muslims	more than half the children are muslims
this has led them in a fruitless and destructive policy circle	this has led them
the flat report followed a four-month string of declines	the flat report followed a four-month string
newspapers including this one have generally ignored his news releases	newspapers have generally ignored his news releases
prices on the frankfurt stock exchange tumbled in heavy trading	prices tumbled
only 42 % of last year 's respondents anticipated slowing growth	only 42 % anticipated slowing growth
keepers of the books dubbed figure filberts loathed the threat	keepers dubbed figure filberts loathed the threat
loyalty lags most for utilitarian products like trash bags and batteries	loyalty lags most
mr. tinker later left to become chairman of national broadcasting co	mr. tinker later left to become chairman
at the core of mr. loggia 's mancuso is his world-weary truculence	is his world-weary truculence
murder threat charged in haas securities corp stock-manipulation trial	murder threat charged
does the candidate favor parental consent for teen-age abortions	does the candidate favor parental consent
bigger than a breadbox was this cash hoarder 's reputation for honesty	bigger was this cash hoarder 's reputation
the march contract advanced 0.14 cent a pound to 14.11 cents	the march contract advanced 0.14 cent a pound
the position of chief operating officer is new	the position is new
shearson does n't break out the earnings of its subsidiaries	shearson does n't break out the earnings
she bursts into tears and walks away	she bursts and walks away
so mr. moon is in retreat refocusing on the far east	so mr. moon is refocusing
average attendance at their games about 49,000 last year continues flat	average attendance about 49,000 last year continues flat
waterford has decided against paying an interim dividend	waterford has decided
revenue rose 12 % to 1.37 billion from 1.22 billion	revenue rose 12 %
in addition global petroleum demand has been climbing	global petroleum demand has been climbing
istat said 369,000 more people were employed in july than in april	istat said 369,000 more people were employed
meanwhile sotheby 's guarantee is raising eyebrows in the art world	meanwhile sotheby 's guarantee is raising eyebrows
and most vacationers still prefer a warm climate for their winter excursions	and most vacationers still prefer a warm climate
it would open a can of worms	it would open a can
once again the indomitable peasant holds poland 's future in his hands	once again the indomitable peasant holds poland 's future
mr. maynard says the ruling pushed his company into bankruptcy court	mr. maynard says the ruling pushed his company
but then it was acquired by household international inc	but then it was acquired
pacific telesis group lost 62.5 cents to 44.625	pacific telesis group lost 62.5 cents
that 's good news because we all swim in this water	that 's good news because we all swim
other rjr issues fell between 1\/2 point and 1 1\/2 point	other rjr issues fell
the election was by secret ballot in the general assembly	the election was
a star attraction on the national network is the u.s. 's dynasty	a star attraction is the u.s. 's dynasty
the main obstacle is finding a way to pay for them	the main obstacle is finding a way to pay
in my opinion this is not true	this is not true
but the money is n't peanuts either particularly for a news program	but the money is n't peanuts either
several projects he said are still on the drawing board	several projects he said are still
that share has remained at about 24 % since 1970	that share has remained
recruiter donald clark does note an increase in searches for minority candidates	recruiter donald clark does note an increase
the bank said the talks resulted from solicitations by its financial adviser	the bank said the talks resulted
each right entitles shareholders to buy one-half share of common for 30	each right entitles shareholders to buy one-half share
mr. strieber knows a lot about aliens	mr. strieber knows a lot
the bonds are insured and rated triple-a by moody 's and s&p	the bonds are insured and rated triple-a
the afrikaner must end his reliance on others	the afrikaner must end his reliance
i was in stinson beach when the quake rolled through town	i was when the quake rolled
santa cruz county estimates total damage at nearly 600 million	santa cruz county estimates total damage
the beginning was chaotic said nigel longley a broker for commerzbank ag	the beginning was chaotic said nigel longley a broker
valued at 1.3 million it was part of a four-crate shipment	valued it was part
last week traders said there were three institutional sellers for every buyer	last week traders said there were three institutional sellers
all these reports about him committing genocide are probably exaggerated anyway	all these reports are probably exaggerated anyway
mr. bates usually handles day-to-day ual trading on his own	mr. bates usually handles day-to-day ual trading
ibm shares closed at 103 down 50 cents in big board trading	ibm shares closed
in my freshman year my roommate was known as a party animal	my roommate was known
mr. bostian said in august that his macroeconomic index signaled recession	mr. bostian said that his macroeconomic index signaled recession
it can happen in any industry	it can happen
crime is clearly more deadly to small-scale entrepreneurship than to big businesses	crime is clearly more deadly
obviously we are looking at making economies across the board	obviously we are looking
the stocks of computer-related companies located outside california improved too	the stocks improved too
it does n't look nice on the outside while getting mealy inside	it does n't look nice while getting mealy inside
but i 'm going to proceed in a more logical way	but i 'm going to proceed
the name of the game is to move goods	the name is to move goods
bond market analysts say the institutional selling was triggered by several factors	bond market analysts say the institutional selling was triggered
all three funds posted negative returns for the year to date	all three funds posted negative returns
medstone international plummeted 3 1\/4 to 7 1\/4	medstone international plummeted 3 1\/4
brand loyalty was stronger among older consumers in the journal survey	brand loyalty was stronger
the slack absorbs the pulling strain generated by an earthquake	the slack absorbs the pulling strain generated
sales rose 7 % to 3.8 billion	sales rose 7 %
it pays to follow a management career path even at law firms	it pays to follow a management career path
nguyen thi thi is vietnam 's entrepreneur of the 1980s	nguyen thi thi is vietnam 's entrepreneur
he speaks only in filipino	he speaks only
analysts said the company 's troubles mirror those of the industry	analysts said the company 's troubles mirror those
judge mayer was not on the three-member panel	judge mayer was not
politburo member joachim herrman confessed to a grave concern over hungarian democracy	politburo member joachim herrman confessed
we do n't know how to get from socialism to capitalism	we do n't know how to get
creative accounting is a hallmark of federal credit	creative accounting is a hallmark
sea containers which unveiled a proposed restructuring advanced 1 to 62	sea containers which unveiled a proposed restructuring advanced 1
the service supplies weekly reports on school and college construction plans	the service supplies weekly reports
a p&g spokeswoman confirmed that shipments to phoenix started late last month	a p&g spokeswoman confirmed that shipments started late last month
under the agreement hofi will own 87.2 % of the combined company	hofi will own 87.2 %
now those routes are n't expected to begin until jan	now those routes are n't expected to begin
earnings of female workers were unchanged	earnings were unchanged
like many sports buffs mr. engelken has turned cynic	mr. engelken has turned cynic
lone star 's bond corp. parent for instance hails from perth australia	lone star 's bond corp. parent hails
we 'll raise it through bank loans	we 'll raise it
the percentage change is since year-end	the percentage change is
the company is exposed to bulk chemicals however	the company is exposed however
goldman sachs 's mr. einhorn for one subscribes to that scenario	goldman sachs 's mr. einhorn subscribes
revenue rose slightly to 3.8 billion from 3.7 billion	revenue rose slightly
prudential-bache said the york issue was delayed because of market conditions	prudential-bache said the york issue was delayed
mr. warren will remain on the company 's board	mr. warren will remain
the interest-only securities will be sold separately by bt securities	the interest-only securities will be sold separately
but the board said it was n't interested for now	but the board said it was n't interested
per-share net rose to 14.95 yen from 14.44 yen	per-share net rose
the investment community for one has been anticipating a speedy resolution	the investment community has been anticipating a speedy resolution
this pattern was particularly evident among more highly educated couples	this pattern was particularly evident
the previous five reports were mainly statistical but clear enough in outline	the previous five reports were mainly statistical but clear enough
he said the transaction was made for investment purposes	he said the transaction was made
d percentage change is greater than 999 %	d percentage change is greater
the title of chief executive officer is n't used	the title is n't used
the suit seeks in excess of 350,000 in damages	the suit seeks
the loan to umno was made in september 1983	the loan was made
the project known as lotus mansion has been mired in controversy	the project known has been mired
or land in russia so often	or land so often
after being whipsawed by a volatile stock market treasury bonds closed higher	treasury bonds closed higher
intel also added 3\/8 to 33 7\/8	intel also added 3\/8
not everyone has jumped on the breeden bandwagon however	not everyone has jumped however
the four lawyers climbed out from under a table	the four lawyers climbed
businessmen took their cue from the engineers	businessmen took their cue
but with every step i take i 'm building wealth	but i 'm building wealth
the industrial average closed down 18.65 to 2638.73	the industrial average closed down 18.65
but he said dentsu has n't looked seriously at saatchi	but he said dentsu has n't looked seriously
standard & poor 's corp. has them under review	standard & poor 's corp. has them
relational technology went public in may 1988 at 14 a share	relational technology went public
interest during first year paid semiannually at 7.51 %	interest paid semiannually
other furriers have also placed more weight on retailing	other furriers have also placed more weight
they all said they invested huge amounts of money	they all said they invested huge amounts
three were chauffeurs for j. edgar hoover and two cleaned his house	three were chauffeurs and two cleaned his house
jaguar finished 4 lower at 694	jaguar finished 4 lower
mr. jelenic had been executive vice president for operations	mr. jelenic had been executive vice president
until now most japanese charges have been responses to suits against them	most japanese charges have been responses
urban is the company 's first telephone subsidiary in wisconsin	urban is the company 's first telephone subsidiary
laurie mcginley contributed to this article	laurie mcginley contributed
now he said a slowdown in economic activity has slackened demand	now he said a slowdown has slackened demand
he is president and chief executive officer of comerica inc. in detroit	he is president and chief executive officer
intertan jumped 2 1\/4 to 56 7\/8	intertan jumped 2 1\/4
the tribunal is scheduled to rule on the request friday	the tribunal is scheduled to rule friday
venice has sunk 10 inches in this century	venice has sunk 10 inches
i see no major support until 2200	i see no major support
but again they may need the help of the machinists	but again they may need the help
he believes those defenses might well apply to the bay bridge collapse	he believes those defenses might well apply
the landscape architects were expelled from the garden in july	the landscape architects were expelled
harsco produces products for defense industrial commercial and construction markets	harsco produces products
now mr. broberg a lawyer claims he 'd play for free	now mr. broberg a lawyer claims he 'd play
only a few books fell in the reading room	only a few books fell
the university is considering a settlement proposal made by connaught	the university is considering a settlement proposal made
in addition neurologists were beginning to report these observations as well	neurologists were beginning to report these observations as well
grumman corp. was given a 15 million navy contract for aircraft-electronics improvements	grumman corp. was given a 15 million navy contract
some diaries simply are n't worth snooping in	some diaries simply are n't worth snooping
in april the psyllium bandwagon got more crowded	the psyllium bandwagon got more crowded
united illuminating 's plan however offers more for unsecured creditors	united illuminating 's plan however offers more
the strategy boosts current yield by putting more bonds into the portfolio	the strategy boosts current yield
the charts show how househld assets have been distributed over time	the charts show how househld assets have been distributed
the plant employs between 800 and 900 on three shifts	the plant employs between 800 and 900
i can do five things at once to be a businessman	i can do five things to be a businessman
keep some money available for opportunities he says	keep some money available he says
in the 1988 quarter the bank earned 1.1 million	the bank earned 1.1 million
broader market averages were little changed in the latest session	broader market averages were little changed
fortunately the nations of southern africa have n't totally surrendered their sovereignty	fortunately the nations have n't totally surrendered their sovereignty
earnings from the bank 's global consumer business grew 27 %	earnings grew 27 %
the following issues were recently filed with the securities and exchange commission	the following issues were recently filed
revenue rose 15 % to 36 million from 31.2 million	revenue rose 15 %
i do n't know what the risk is of holding the stock	i do n't know what the risk is
he temporarily abandoned his search for the reuters shares	he temporarily abandoned his search
until 1963 it was good soil	it was good soil
older people help profits by filling in downtime	older people help profits
in some industries like pharmaceuticals acquisitions make sense	acquisitions make sense
two steps are necessary to translate this idea into action	two steps are necessary to translate this idea
but sen. mitchell buoyed by his victory among fellow democrats strongly disagreed	but sen. mitchell buoyed strongly disagreed
sometimes repairs are out of the question	sometimes repairs are
now a new law in texas seems to be providing the proof	now a new law seems to be providing the proof
in canton givaudan 's representative office received no orders in june	givaudan 's representative office received no orders
i 'm happy that he feels positively about our company he said	i 'm happy that he feels positively he said
bradley a. stertz in detroit contributed to this article	bradley a. stertz contributed
the s&p 500 is often used in arbitrage strategies	the s&p 500 is often used
some plan to pursue foreign development ventures mostly in europe	some plan to pursue foreign development ventures
the acquisition strengthens bsn 's position in the european pasta market	the acquisition strengthens bsn 's position
sales increased 6 % to 5.58 billion from 5.27 billion	sales increased 6 %
hanson is a london producer of consumer and other goods	hanson is a london producer
power of suggestion stronger in japan	power stronger
that account had been handled by della femina mcnamee wcrs	that account had been handled
for employee and employer alike the worry is widespread	the worry is widespread
as he sums it up we are listening to the market	as he sums it up we are listening
for financial analysts reading omni 's accounts is a tough challenge	reading omni 's accounts is a tough challenge
more than three-fourths of poor black families were headed by women	more than three-fourths were headed
the percentage change is since year-end	the percentage change is
as a result the company has suspended its quarterly dividend	the company has suspended its quarterly dividend
under the program norfolk plans to acquire shares in the open market	norfolk plans to acquire shares
indeed mccaw seemed to hint at that option in a brief statement	indeed mccaw seemed to hint
how can it make available funds for purchases	how can it make available funds
the contract settled at 1,014 a ton off 13	the contract settled off 13
the account had been at della femina mcnamee wcrs new york	the account had been
so developers are saying they will look into distressed properties	so developers are saying they will look
it 's understood several compromises already have been worked into the plan	it 's understood several compromises already have been worked
americans are expected to conform to the japanese culture when in japan	americans are expected to conform when
in over-the-counter national trading bowater inc. jumped 1.50 to 27.50	bowater inc. jumped 1.50
as for the women they 're pathetic	they 're pathetic
continental airlines is a unit of texas air corp. houston	continental airlines is a unit
some producers seem tentative about the technique squeamish even	some producers seem tentative squeamish even
either way the word broker is clearly out of favor	either way the word broker is clearly
in an efficient setup the same pc could perform all those tasks	the same pc could perform all those tasks
aside from computer-guided selling airline stocks took a beating as well	aside airline stocks took a beating as well
after all he says we 've got like 15 million bureaucrats	he says we 've got like 15 million bureaucrats
nothing has changed fundamentally in the tokyo market	nothing has changed fundamentally
what does this mean for trade policy	what does this mean
thermal paper is used in facsimile machines	thermal paper is used
he added we have no intention of selling either business	he added we have no intention
microsoft earned 3.03 a share in fiscal 1989	microsoft earned 3.03 a share
they will be available in minimum denominations of 10,000	they will be available
he will continue as a director	he will continue
but the new lens became the eye of a storm	but the new lens became the eye
sales of long-distance services an extremely competitive market rose 6.4 %	sales rose 6.4 %
u.k. sales for last year 's quarter were about 3 million	u.k. sales were about 3 million
their relationship with mr. sugarman soured shortly thereafter	their relationship soured shortly thereafter
adults have had access to the only approved antiviral drug since 1987	adults have had access
sometimes says his wife we 're happy about that	sometimes says his wife we 're happy
i think i had to prove myself to her says mr. mcduffie	i think i had to prove myself says mr. mcduffie
prices peaked at 1,150,000 in september 1987	prices peaked
taken together the worries prompted a broad sell-off of stocks	taken together the worries prompted a broad sell-off
mr. gelbart also has fun with language	mr. gelbart also has fun
tokyu department store advanced 260 to 2410	tokyu department store advanced 260
concorde trans-atlantic flights are 2,400 to paris and 3,200 to london	concorde trans-atlantic flights are 2,400 and 3,200
his attorney could n't be reached for comment	his attorney could n't be reached
the first merkur the xr4ti went on sale in early 1985	the first merkur the xr4ti went
chase and citicorp 's citibank are involved in the ual buy-out financing	chase and citicorp 's citibank are involved
that 's different than wrecking them	that 's different
most of us know a sucker	most know a sucker
the unit has 30 employees in four california offices the company said	the unit has 30 employees the company said
ratings he notes are subject to change	ratings he notes are subject
i see a possibility of going to 2200 this month	i see a possibility
and you ca n't cut this chain with bolt cutters	and you ca n't cut this chain
the pound strengthened to 1.5795 from 1.5765	the pound strengthened
in a way that 's what this is mr. gonzalez concedes	that 's what this is mr. gonzalez concedes
bishop is based in hutchinson kansas	bishop is based
but for photofinishers developing costs for black-and-white film are higher	but developing costs are higher
share prices in frankfurt closed narrowly mixed after listless and directionless trading	share prices closed narrowly mixed
the vote of 345-47 sent the measure to the senate	the vote sent the measure
nonperformers totaled 230.8 million or 1.27 % in the year-ago third quarter	nonperformers totaled 230.8 million or 1.27 %
now we 're at the bottom of the heap	now we 're
the u.s. and finland signed an income-tax treaty subject to ratification	the u.s. and finland signed an income-tax treaty subject
suddenly i am not a comfortable man for solidarity	suddenly i am not a comfortable man
this is a democratic process you ca n't slam-dunk anything around here	this is a democratic process you ca n't slam-dunk anything
futures prices recovered in quiet trading	futures prices recovered
the chimney is a pile of bricks on the front lawn	the chimney is a pile
here in south texas we say tie-vole-ee my host gently corrects	here we say tie-vole-ee my host gently corrects
they were the signature of his adversary panamanian leader manuel antonio noriega	they were the signature
unlike most loans to china there was no chinese guarantor	there was no chinese guarantor
i refer essentially to petroleum electric power banking and newsprint	i refer essentially
senator byrd is chairman of the appropriations committee	senator byrd is chairman
it has to be engineered over and over again month after month	it has to be engineered over and over again month
but she stressed i am against managed trade	but she stressed i am
the march contract was off 0.32 cent a pound at 13.97 cents	the march contract was off 0.32 cent a pound
you went to college and thought you got an education	you went and thought you got an education
those activities generated 26.1 million in operating profit last year	those activities generated 26.1 million last year
cracking the top 10 within three years will be difficult at best	cracking the top 10 will be difficult at best
where 's this huge amount of investment capital coming from	where 's this huge amount coming
one of their pastors has envisioned a new utopia of creative socialism	one has envisioned a new utopia
collagen dropped 2 5\/8 to 15 5\/8 on 428,000 shares	collagen dropped 2 5\/8
freddie mac 9 % securities were at 97 4\/32 down 1\/32	freddie mac 9 % securities were down 1\/32
revenue rose 11 % to 4.56 billion from 4.12 billion	revenue rose 11 %
in japan about 1 % are linked	about 1 % are linked
prepayments much like mutual-fund purchases are pooled for investment	prepayments are pooled
at the same time second-tier firms will continue to lose ground	second-tier firms will continue to lose ground
it is a quick fix for a complex problem	it is a quick fix
that is the key to the current national disease	that is the key
that 's good news for marketers of walking shoes	that 's good news
of course mr. mason did not use neutral language	mr. mason did not use neutral language
needless to say he was talking about rico	needless to say he was talking
the venezuelan central bank set a 30 % floor on the bidding	the venezuelan central bank set a 30 % floor
apogee was quoted in the over-the-counter market yesterday at 2 bid	apogee was quoted yesterday
retailers are just in disarray	retailers are just
that way they can be home in time for work sunday	that way they can be home
it is payable dec. 10 to stock of record nov. 24	it is payable dec. 10
analysts are downbeat about ibm 's outlook for the next few quarters	analysts are downbeat
analysts said a big japanese buy order was behind the rise	analysts said a big japanese buy order was
it puts this president in the legislative business he declares	it puts this president he declares
mr. shaffer takes primary responsibility for the electronic and technical-services group	mr. shaffer takes primary responsibility
first options did n't have to put any money into the bailout	first options did n't have to put any money
for one thing credit-card loans are unsecured	credit-card loans are unsecured
a bid against paribas could n't be ruled out	a bid could n't be ruled out
it recently reported assets of 2.4 billion and liabilities of 4 billion	it recently reported assets and liabilities
north atlantic industries jumped 1 to 5 3\/4	north atlantic industries jumped 1
within 25 years jews will probably be the minority	jews will probably be the minority
yet they do n't disparage their audiences by disparaging their act	yet they do n't disparage their audiences
mr. todt had been vice president and treasurer of insilco corp	mr. todt had been vice president and treasurer
state government is more typically split along republican-governor\/democratic-legislature lines than the reverse	state government is more typically split
but mr. lagnado predicted the regional trends would continue through christmas	but mr. lagnado predicted the regional trends would continue
the comic strip has a magical everlasting quality about it	the comic strip has a magical everlasting quality
beyond that money managers and analysts see other problems	money managers and analysts see other problems
at the core of it all is a love for plants	is a love
the heavy selling by farmers helped to damp the price rally	the heavy selling helped to damp the price rally
per-share net rose to 44.08 yen from 36.13 yen	per-share net rose
we view it as a good long-term investment the spokesman said	we view it the spokesman said
bankamerica 's total loans rose 8 % to 71.36 billion	bankamerica 's total loans rose 8 %
i do n't see this as a bear market at all	i do n't see this at all
advertising volume at the company 's 35 regional newspapers decreased 1.1 %	advertising volume decreased 1.1 %
mr. edelson could n't be reached for comment	mr. edelson could n't be reached
strong farmer selling over the weekend also weighed on prices	strong farmer selling also weighed
certain details of the restructured facilities remain to be negotiated	certain details remain to be negotiated
in american stock exchange composite trading isi closed up 3.125 at 18.625	isi closed up 3.125
amr has not been and is not for sale	amr has not been and is not
the plan is talking about applicants admitted not students who enroll	the plan is talking
the modest sell-off which started on tuesday continued	the modest sell-off which started continued
parts of the houston ship channel were closed	parts were closed
there were rumors of 148-a-share trades	there were rumors
for now both companies are keeping quiet about their specific plans	for now both companies are keeping quiet
measured the same way the decline for black males was 14.2 %	measured the same way the decline was 14.2 %
talk hurts from where it spurts one of them says	talk hurts one says
volume on the new york stock exchange totaled 176.1 million shares	volume totaled 176.1 million shares
adverse pressure on gross margins has subsided mr. sculley said	adverse pressure has subsided mr. sculley said
why should anybody want to sell to them	why should anybody want to sell
on june 30 loss reserves stood at 108.3 million	loss reserves stood
john r. wilke contributed to this article	john r. wilke contributed
when it went down by all tradition the economy followed	when it went down the economy followed
companies move in and out says helga kern of kk swiss investment	companies move in and out says helga kern
in addition the company cited cost-reduction moves and interest income	the company cited cost-reduction moves and interest income
the restaurant was conceived as a sparkling crystalline geode	the restaurant was conceived
an assassin in colombia killed a federal judge on a medellin street	an assassin killed a federal judge
competitors are known as the enemy	competitors are known
the ads celebrate the achievements of some of lake view 's residents	the ads celebrate the achievements
some in the industry are skeptical	some are skeptical
the new closed-end management investment company trades shares of beneficial interest	the new closed-end management investment company trades shares
the spokeswoman said the exchange would resume trading of delmed stock today	the spokeswoman said the exchange would resume trading today
i do not by any means defend hud management	i do not defend hud management
dragging prop. 13 into this story is a pretty long stretch	dragging prop. 13 is a pretty long stretch
third-quarter revenue rose to 4.9 billion from 4.7 billion	third-quarter revenue rose
in the recent past bond buyers did n't seek such assurance	bond buyers did n't seek such assurance
closer to home the negotiators were more generous	closer the negotiators were more generous
the issue will be sold through morgan stanley & co	the issue will be sold
the irs delays several deadlines for hugo 's victims	the irs delays several deadlines
the notes will have a principal amount of 300 million at maturity	the notes will have a principal amount
december delivery gold eased 40 cents an ounce to 380.80	december delivery gold eased 40 cents an ounce
the fund now holds a cash position of about 15 %	the fund now holds a cash position
december silver was off 3.7 cents an ounce at 5.2830	december silver was off 3.7 cents an ounce
robert g. hodson 65 retired as chairman but will remain a consultant	robert g. hodson 65 retired but will remain a consultant
david b. hilder in new york contributed to this article	david b. hilder contributed
lead underwriter to the issue is toronto dominion securities inc	lead underwriter is toronto dominion securities inc
that 's what they 're after	that 's what they 're
the film makers have couched this offensive idea in pretty packaging	the film makers have couched this offensive idea
c translated at commercial rand exchange rate	c translated
expenses unrelated to interest rose 5.4 % to 541 million	expenses unrelated rose 5.4 %
the union will keep a 2 % commission on construction projects	the union will keep a 2 % commission
just after midnight monday federal spending started to drop by 16 billion	monday federal spending started to drop
mr. bauman a conservative says he was deserted by the right wing	mr. bauman a conservative says he was deserted
american institutional investors have never had a large appetite for japanese equities	american institutional investors have never had a large appetite
mission resource partners advanced 8 % or 1 3\/8 to 18 7\/8	mission resource partners advanced 8 % or 1 3\/8
this could be a big protest against an administrative failure	this could be a big protest
some traders said the high-yield market was helped by active institutional buying	some traders said the high-yield market was helped
yet he has proved more resilient than any of them	yet he has proved more resilient
the reversal was even more evident among shorter-term treasury securities	the reversal was even more evident
fear is the father of panic	fear is the father
they stroll through the marble-encased corridors of the atrium court	they stroll
national market system volume improved to 94,425,000 shares from 71.7 million monday	national market system volume improved
i do n't talk about my work he says	i do n't talk he says
in recent years growth has come in the foreign markets	growth has come
it was great to have the luxury of time mr. rawls said	it was great to have the luxury mr. rawls said
a buy-and-hold approach to stocks continues to be the rule among respondents	a buy-and-hold approach continues to be the rule
revenue slipped 4.6 % to 835 million from 876 million	revenue slipped 4.6 %
i think this is a market that required some level of security	i think this is a market that required some level
rjr nabisco pays up to 30,000 of losses including improvements	rjr nabisco pays up to 30,000
of the 4,345 stocks that changed hands 1,174 declined and 1,040 advanced	1,174 declined and 1,040 advanced
the final package is expected to be announced within the next week	the final package is expected to be announced
fresenius owns about 42 % of delmed 's fully diluted common stock	fresenius owns about 42 %
revenue eased 0.3 % to 3.45 billion from 3.46 billion	revenue eased 0.3 %
i looked at my watch	i looked
sapporo gained 80 to 1,920 and kirin added 60 to 2,070	sapporo gained 80 and kirin added 60
the asset shrinkage was particularly concentrated in several large california institutions	the asset shrinkage was particularly concentrated
money is n't the only reason for the shift in practice preferences	money is n't the only reason
there was no immediate estimate of damage from the company	there was no immediate estimate
the union is continuing to work through its expired contract however	the union is continuing to work however
that has n't deterred plenty of companies	that has n't deterred plenty
rates approach 6.5 % on five-year municipals	rates approach 6.5 %
after that it will make a final decision on the policy	it will make a final decision
there 's nothing unusual about business groups pushing for more government spending	there 's nothing unusual
it 's not good the market is setting up for another fall	it 's not good the market is setting up
but his release within the next few months is widely expected	but his release is widely expected
revenue edged up to 8.9 billion from 8.81 billion	revenue edged up
all of the bidders contemplate full payment including interest to secured creditors	all contemplate full payment
china 's leaders have promised generous liberties for post-1997 hong kong	china 's leaders have promised generous liberties
new zealand 's finance minister david caygill lashed out at such suggestions	new zealand 's finance minister david caygill lashed out
it is a peaceful time in this part of western india	it is a peaceful time
that 's about half the price of comparably equipped ibm mainframes	that 's about half the price
their commitment to creativity can not survive adolescent illiteracy	their commitment can not survive adolescent illiteracy
third-quarter earnings at both companies were below analysts ' forecasts	third-quarter earnings were
the surge in production analysts say raises questions about capacity outpacing demand	the surge analysts say raises questions
the bank has been making adjustment loans for 10 years	the bank has been making adjustment loans
professional crisco products are specially made for the foodservice industry	professional crisco products are specially made
it has some of the highest costs in the league	it has some
the kennedy amendment would in effect legislate around the supreme court ruling	the kennedy amendment would legislate
business lines increased 3.7 % to 3.3 million	business lines increased 3.7 %
previously it had proposed seven years of 5.5 % increases	previously it had proposed seven years
for instance employment in denver will be reduced to 105 from 430	employment will be reduced
outside i spotted two young men lugging blocks of concrete	outside i spotted two young men lugging blocks
did mr. freeman have notice of this	did mr. freeman have notice
gasb rules still apply for other government units	gasb rules still apply
but 93 % of tourists still come for gambling	but 93 % still come
most are anchored by a k mart store	most are anchored
trading activity cooled off from monday 's sizzling pace	trading activity cooled off
safety authorities did n't immediately know the cause of the blasts	safety authorities did n't immediately know the cause
the independent-contractor project which began in 1988 involves about 350 irs agents	the independent-contractor project which began involves about 350 irs agents
mr. regal had been president and chief executive of rbs industries inc	mr. regal had been president and chief executive
michael shares closed at 13 3\/4 yesterday in national over-the-counter trading	michael shares closed yesterday
if not we could go to 2200 very soon	if not we could go very soon
gerald f. seib and joe davidson in washington contributed to this article	gerald f. seib and joe davidson contributed
disclosures are very poor in india	disclosures are very poor
i 'm for the giants today but only because they lost yesterday	i 'm today but only because they lost yesterday
sales rose 8 % to 456.2 million from 422 million	sales rose 8 %
mr. quennell has said he plans to go with the grid regardless	mr. quennell has said he plans to go regardless
but retail energy prices declined 0.9 % in september	but retail energy prices declined 0.9 %
ima also will assume 1.4 billion in debt	ima also will assume 1.4 billion
for that matter perhaps he fixed to the wrong currency	perhaps he fixed
pratt & whitney is a unit of united technologies inc	pratt & whitney is a unit
two new remics totaling 900 million were announced by freddie mac yesterday	two new remics totaling 900 million were announced yesterday
stocks rose in london but fell again in frankfurt	stocks rose but fell again
it was nothing more or nothing less than a feeding frenzy	it was nothing more or nothing less
yesterday gold traded within a narrow range	yesterday gold traded
there 's no constitutional right involved in the rule change he says	there 's no constitutional right involved he says
they painted the apartment orange pink and white according to her instructions	they painted the apartment orange pink and white
empire pencil later called empire-berol developed the plastic pencil in 1973	empire pencil later called empire-berol developed the plastic pencil
the pilots argued that this triggered a pay raise for them	the pilots argued that this triggered a pay raise
for one thing digital maynard mass. has sold fewer machines	digital maynard mass. has sold fewer machines
shearson lehman hutton began its coverage of the company with favorable ratings	shearson lehman hutton began its coverage
i ca n't support him because of abortion	i ca n't support him
offices were set up in san francisco and san jose	offices were set up
silver however is in a deeper slump than are gold and platinum	silver however is
wall street shake hands with george orwell	wall street shake hands
he was later shown on television fielding questions	he was later shown fielding questions
manufacturers hanover had a loss due to a big reserve addition	manufacturers hanover had a loss due
he left a message accusing mr. darman of selling out	he left a message accusing mr. darman
an oil company finds a sideline in the microscopic world of yeast	an oil company finds a sideline
cilcorp will also assume 22 million of hunter 's existing debt	cilcorp will also assume 22 million
but we do n't minimize the challenges of the near term	but we do n't minimize the challenges
by the end of the day bond prices were mixed	bond prices were mixed
the cement producer said the payment was made from excess cash flow	the cement producer said the payment was made
similar sentiments were voiced on capitol hill	similar sentiments were voiced
mr. trivelpiece 58 years old succeeds william bolger who died in august	mr. trivelpiece 58 years old succeeds william bolger who died
the uncertainty is sending shivers through brazilian financial markets	the uncertainty is sending shivers
mitchell will get a half-interest in the oil	mitchell will get a half-interest
municipal mortgage-backed and investment-grade corporate bonds rose 1\/8 to 1\/2 point	municipal mortgage-backed and investment-grade corporate bonds rose 1\/8
for the first nine months of 1989 central earned 2 million	central earned 2 million
hugo's blast generates pleas for aid from south carolina small businesses	hugo's blast generates pleas
thanks to modern medicine more couples are growing old together	thanks more couples are growing old together
they now are experimenting with measuring blood flow	they now are experimenting
valley federal with assets of 3.3 billion is based in van nuys	valley federal is based
red tape is the bugaboo of small business	red tape is the bugaboo
similar proposals were defeated in at least 15 other states	similar proposals were defeated
they believe the media including batibot have played a crucial role	they believe the media have played a crucial role
the new company is capitalized at about 3.5 million	the new company is capitalized
in last week 's house vote 41 republicans defected	41 republicans defected
cars ca n't move because of overflowing sewers	cars ca n't move
among the most upbeat was bt brokerage asia ltd	was bt brokerage asia ltd
which types of stocks currently have the greatest earnings risks	which types currently have the greatest earnings risks
marketing and sales departments then urged abandonment of the pico project	marketing and sales departments then urged abandonment
the show also signals mr. vila 's return as a television celebrity	the show also signals mr. vila 's return
investors in b.a.t have been on a roller coaster	investors have been
i think it 's on the way back now	i think it 's now
the financial times 30-share index ended 13.6 higher at 1772.1	the financial times 30-share index ended 13.6 higher
there was tremendous public enthusiasm for stock mutual funds	there was tremendous public enthusiasm
conner peripherals was unchanged at 15	conner peripherals was unchanged
but again the themes get tangled in mr. mahfouz 's elliptical storytelling	but again the themes get tangled
until last week mr. dinkins was considered a shoo-in	mr. dinkins was considered a shoo-in
and investors at least for now took a pass	and investors took a pass
the merger requires the approval of norwegian authorities	the merger requires the approval
smaller projects swell the figure to at least 2.5 billion	smaller projects swell the figure
the nasdaq financial index rose 2.09 to 454.86	the nasdaq financial index rose 2.09
it was like a play on broadway recalls mr. martinez	it was recalls mr. martinez
sales rose 2 % to 437.5 million from 430.3 million	sales rose 2 %
the trip from the test tube was not without snags	the trip was not
but some analysts remain sour on the company	but some analysts remain sour
the timing for change was right	the timing was right
the monthly increase is the highest recorded in the past four years	the monthly increase is the highest recorded
traders shouted as their screens posted an ever-narrowing loss on wall street	traders shouted as their screens posted an ever-narrowing loss
the dollar posted gains in quiet trading as concerns about equities abated	the dollar posted gains as concerns abated
revenue grew 24 % to 614.5 million from 497.1 million	revenue grew 24 %
revenues climbed 18 % to 289 million from 245.3 million	revenues climbed 18 %
it all started with geography	it all started
i had calls all night long from the states he said	i had calls all night long he said
competition in the sale of complete bikes is heating up too	competition is heating up too
her recent report classifies the stock as a hold	her recent report classifies the stock
in major market activity stock prices surged in heavy trading	stock prices surged
but he warned the currency will remain at risk	but he warned the currency will remain
terms of the accord were n't disclosed	terms were n't disclosed
company with 1,750 workers in area is fully functional	company is fully functional
on friday mortgage issues gained as much as 1 5\/32	mortgage issues gained as much
thereafter interest paid annually at 7.65 %	thereafter interest paid annually
in sidhpur it is almost time to sow this year 's crop	it is almost time to sow this year 's crop
i heard parts of the building above my head cracking	i heard parts cracking
healthvest missed an interest payment to bank of tokyo on oct. 1	healthvest missed an interest payment
have the freedoms of glasnost gone to mr. ovcharenko 's head	have the freedoms gone
nekoosa ranked 11th with sales of 3.59 billion	nekoosa ranked 11th
sales were 4.2 billion compared with 3.7 billion	sales were 4.2 billion
mr. taft paid an average of 28.43 for each share	mr. taft paid an average
by 10 a.m. it was down 49	it was down 49
analysts had mixed responses to the results	analysts had mixed responses
many of us are suckers	many are suckers
a seagram spokesman in new york would n't comment	a seagram spokesman would n't comment
many of the branches are very lucrative she says	many are very lucrative she says
and black-and-white photography classes are crowded with students	and black-and-white photography classes are crowded
superconcentrates are n't entirely new for p&g	superconcentrates are n't entirely new
the rest of the world accepted such methods when japan was developing	the rest accepted such methods when japan was developing
companies are still going to buy companies around the world he says	companies are still going to buy companies he says
last year 's retrenchment dried up the working capital of chinese factories	last year 's retrenchment dried up the working capital
it is the new journalism come to television	it is the new journalism come
for years costume jewelry makers fought a losing battle	costume jewelry makers fought a losing battle
he 's totally geared to a punitive position	he 's totally geared
the rise matches that of the dow jones industrials this year	the rise matches that this year
and they will again say money-manager proponents of the growth-stock theme	and they will again say money-manager proponents
opinion is mixed over its three-month prospects	opinion is mixed
welcome to the 28th tokyo motor show	welcome
a dozen white office workers fold newsletters and stuff them into envelopes	a dozen white office workers fold newsletters and stuff them
the report follows five-consecutive declines in full monthly figures	the report follows five-consecutive declines
spokesmen for wendy 's and mcdonald 's criticized mr. rohs 's calculations	spokesmen criticized mr. rohs 's calculations
other major players in intimate apparel apparently feel the same way	other major players apparently feel the same way
hopes of simplifying the corporate minimum tax before 1990 are weakening	hopes are weakening
we 've seen continued improvement in 1989 she said	we 've seen continued improvement she said
safeco fell 1\/8 to 32 5\/8 on 462,900 shares	safeco fell 1\/8
for vietnamese these are tricky often treacherous times	these are tricky often treacherous times
the less-rigorous senate version would defer the deductibility for roughly five years	the less-rigorous senate version would defer the deductibility
the jokes are n't just on the japanese though	the jokes are n't just though
revenue for the year fell 13 % to 122.7 million	revenue fell 13 %
sungard 's stock rose 1 3\/4 to 21 1\/4 on 194,000 shares	sungard 's stock rose 1 3\/4
the fund 's lawyers work in an athenian grove of potted trees	the fund 's lawyers work
their ridicule of him is no substitute for argument	their ridicule is no substitute
besides we have enough on our plate	besides we have enough
travelers up to age 99 get a percentage discount matching their age	travelers get a percentage discount matching their age
the beginning was chaotic says nigel longley a broker for commerzbank	the beginning was chaotic says nigel longley a broker
the stock was trading at 69 just two weeks ago	the stock was trading just two weeks ago
a spokesman for campeau called the rumors ridiculous	a spokesman called the rumors ridiculous
twenty-five trucks capable of cooking food were dispatched from other states	twenty-five trucks capable were dispatched
treasury bonds ended narrowly mixed in quiet trading	treasury bonds ended narrowly mixed
bigger business can often better afford to minimize the cost of crime	bigger business can often better afford to minimize the cost
the 21-square-mile area is contaminated with lead zinc and other metals	the 21-square-mile area is contaminated
in a bull market credit does not matter mr. devoe added	credit does not matter mr. devoe added
the pressure for change will rise with costs	the pressure will rise
even claims against individuals and companies face significant roadblocks	even claims face significant roadblocks
however the total value declined for deals of 100 million and up	however the total value declined
the acquisition is subject to approval by kennametal 's board	the acquisition is subject
it belonged to her grandfather	it belonged
you eliminate companies with substantial prospects that are moving up in price	you eliminate companies that are moving up
nobody smiled onstage and nobody in the audience was encouraged to laugh	nobody smiled onstage and nobody was encouraged to laugh
unlike 1987 interest rates have been falling this year	interest rates have been falling this year
i care very much for this post he says	i care very much he says
at closing time farmers cart out most of what they carted in	farmers cart out most
sen. dole said that the move required sacrifice by every senator	sen. dole said that the move required sacrifice
officials at mellon capital were unavailable for comment	officials were unavailable
testimony is expected to continue until early december	testimony is expected to continue
bond prices posted strong gains as investors went on a bargain hunt	bond prices posted strong gains as investors went
of the 4,348 issues that changed hands 1,074 advanced and 866 declined	1,074 advanced and 866 declined
mr. patel resigned as senior vice president of par in april	mr. patel resigned
i 'm not looking for a runaway christmas at all he says	i 'm not looking at all he says
he declines to go into specifics	he declines to go
of the 4,346 issues that changed hands 1,435 rose and 629 fell	1,435 rose and 629 fell
german and dutch investors reportedly loaded up on kellogg co	german and dutch investors reportedly loaded up
we are now monitoring for it much more closely he said	we are now monitoring much more closely he said
mr. padovan is currently a director at barclays de zoete wedd ltd	mr. padovan is currently a director
thus we have a condition that is easily described as undemocratic	thus we have a condition that is easily described
in offices triphosphorous bulbs simulate daylight	triphosphorous bulbs simulate daylight
we would even save on freight	we would even save
the securities were priced at 99.1875 to yield about 9.19 %	the securities were priced to yield about 9.19 %
two bills in congress hope to make such restrictions national	two bills hope to make such restrictions national
mr. byrum and ms. smith could n't be reached for comment	mr. byrum and ms. smith could n't be reached
the northeast has been holding its own in the population race	the northeast has been holding its own
the dollar rose modestly against most major currencies	the dollar rose modestly
such centrifugal egg breakers have been around since the 1890s	such centrifugal egg breakers have been around
in birmingham which is 57 % black whites are the minority	whites are the minority
sales for the latest quarter were flat at 1.72 billion	sales were flat
neither testified at the previous trials	neither testified
a prospectus in india does n't always tell a potential investor much	a prospectus does n't always tell a potential investor much
but the specialty-material segment slowed somewhat and consumer products continued below expectations	but the specialty-material segment slowed somewhat and consumer products continued
prices were lower in frankfurt zurich paris and amsterdam	prices were lower
president reagan vetoed this as a first amendment violation	president reagan vetoed this
and in some neighborhoods rents have merely hit a plateau	and rents have merely hit a plateau
the two could n't be reached for comment	the two could n't be reached
litigation consulting is n't a guarantee of a favorable outcome	litigation consulting is n't a guarantee
unlike other companies it has n't pin-pointed specific projects for the funds	it has n't pin-pointed specific projects
glenn hall contributed to this article	glenn hall contributed
fittingly the tela accords were nicknamed by hondurans the dodd plan	fittingly the tela accords were nicknamed the dodd plan
prosecutors in miami received yet another setback	prosecutors received yet another setback
but the market turmoil could be partially beneficial for some small businesses	but the market turmoil could be partially beneficial
it declined to discuss its plans for upgrading its current product line	it declined to discuss its plans
but trading risk stems from credit risk	but trading risk stems
the pilots were meeting outside chicago yesterday	the pilots were meeting yesterday
it added that no discussions about such a sale are under way	it added that no discussions are
dunkin donuts is based in randolph mass	dunkin donuts is based
he could not be reached for comment	he could not be reached
the insured bonds are rated triple-a by moody 's and s&p	the insured bonds are rated triple-a
the dow jones industrials closed at 2569.26	the dow jones industrials closed
here they are searching for a higher price	here they are searching
ginnie mae 13 % securities were down about 1\/4 at 109 30\/32	ginnie mae 13 % securities were down about 1\/4
and oranjemund boasts attractions besides diamonds	and oranjemund boasts attractions
that selling continued yesterday and kept prices under pressure he said	that selling continued yesterday and kept prices he said
she now lives with relatives in alabama	she now lives
some in arizona think that may be optimistic	some think that may be optimistic
in such an arrangement all benefit he said	all benefit he said
but the two groups represent a further step in defensiveness	but the two groups represent a further step
xtra gained 1 1\/8 to 27 1\/8	xtra gained 1 1\/8
indirect subsidies through the fha for instance are little better	indirect subsidies are little better
czeslaw pyszkiewicz owns 30 acres in 14 scattered scraps	czeslaw pyszkiewicz owns 30 acres
the play is filled with intrigue dishonesty and injustice	the play is filled
analysts have mixed views about the two-year note auction	analysts have mixed views
meanwhile competition from rivals unencumbered by history is intensifying	meanwhile competition is intensifying
it 's an attractive market with good growth opportunities he added	it 's an attractive market he added
an acquisition accounted for half the sales rise trw said	an acquisition accounted trw said
in other words a little volatility never hurt	a little volatility never hurt
traders said hedging related to the tva pricing also pressured treasury bonds	traders said hedging related also pressured treasury bonds
he also owns courses in the u.s. and france	he also owns courses
now they 're losers and he 's in jail in mobile county	now they 're losers and he 's
sterling was trading at 1.5805 down from 1.5820 late monday	sterling was trading down
over the next several months though he says things look bad	though he says things look bad
mr. drabinsky could n't be reached for comment	mr. drabinsky could n't be reached
in texas taxes and development costs are also lower they said	taxes and development costs are also lower they said
revenue was 4.75 billion up 6 % from 4.49 billion	revenue was 4.75 billion up 6 %
the chicago exchanges also are working on such a device	the chicago exchanges also are working
kyocera advanced 80 yen to 5,440	kyocera advanced 80 yen
in national over-the-counter trading mci fell 2.625 to 42.375	mci fell 2.625
rep. traxler recently purchased an unimproved building lot on the island	rep. traxler recently purchased an unimproved building lot
it did n't provide details of setup costs	it did n't provide details
seats currently are quoted at 400,000 bid 425,000 asked	seats currently are quoted
that offer was endorsed by the shareholders committee	that offer was endorsed
he added b.a.t has no expectation of a material impact on farmers	he added b.a.t has no expectation
he simply ca n't stomach the taste of heinz she says	he simply ca n't stomach the taste she says
in friday 's edition the name of the unit was misstated	the name was misstated
a few drops in circulation are of no consequence	a few drops are
he succeeds everett meyers who resigned in may	he succeeds everett meyers who resigned
revenue rose 5 % to 986 million from 937 million	revenue rose 5 %
other funds hold a smattering of junk bonds too	other funds hold a smattering too
taipei was closed for a holiday	taipei was closed
but the japanese insist upon japanese managers everywhere they set up shop	but the japanese insist everywhere they set up shop
we just want to have our own cup of tea	we just want to have our own cup
december silver was up 2.3 cents an ounce at 5.163	december silver was up 2.3 cents an ounce
many fund managers have boosted their cash levels in recent weeks	many fund managers have boosted their cash levels
the american stock exchange market value index lost 3.11 to 379.46	the american stock exchange market value index lost 3.11
st. jude finished up 1\/4 to 44 1\/2 on friday	st. jude finished up 1\/4
red figures on the screens indicated falling stocks blue figures rising stocks	red figures indicated falling stocks blue figures rising stocks
we 'll raise it through new equity	we 'll raise it
british petroleum fell 5 to 286 on 14 million shares traded	british petroleum fell 5
the outlook is positive for the intermediate to long term	the outlook is positive
the british government also strongly opposes the charter in its current form	the british government also strongly opposes the charter
accepted theories state that investors require higher returns on riskier investments	accepted theories state that investors require higher returns
both westwood brick and westwood group are based in boston	both westwood brick and westwood group are based
further consolidations in the industry could follow	further consolidations could follow
and so it was on gray friday	and so it was
these benefits seem secure despite china 's current economic and political troubles	these benefits seem secure
ual fell 56.875 to 222.875	ual fell 56.875
rest assured we proceed with exemplary fairness	rest assured we proceed
and for now at least the competition is n't the only enemy	and at least the competition is n't the only enemy
the failure to obtain financing does n't by itself constitute a breach	the failure to obtain financing does n't constitute a breach
he could n't be reached for comment	he could n't be reached
but in the end customers ' wishes are what will prevail	but customers ' wishes are what will prevail
but he thinks investors may be overreacting to the market 's problems	but he thinks investors may be overreacting
the croaker 's done gone from the hook	the croaker 's done gone
when a company realizes that it 's hard to go with wang	when a company realizes that it 's hard to go
general dynamics closed at 54.875 up 50 cents	general dynamics closed up 50 cents
the cftc has 90 days to respond to such applications	the cftc has 90 days to respond
tw 's stockholder meeting was postponed from tomorrow to nov. 21	tw 's stockholder meeting was postponed
at the same time it has been caught in an earnings squeeze	it has been caught
the official said he also would be comfortable with that new range	the official said he also would be comfortable
budget is set at 1.5 million	budget is set
we do n't want to be party to a second rejection	we do n't want to be party
and he has attached himself to the lincoln story tenaciously	and he has attached himself tenaciously
per-share net rose to 55.10 yen from 54.51 yen	per-share net rose
i transmitted my conversations to the white house prof. lee says	i transmitted my conversations prof. lee says
mr. redford no longer stands out as an extremist	mr. redford no longer stands out
revenue soared to 117 million from 81.5 million	revenue soared
the success of a new product in the database line is needed	the success is needed
but the task of improving market performance remains unfinished	but the task remains unfinished
at last report enfield had about 44.5 million shares outstanding	enfield had about 44.5 million shares outstanding
revenue rose 12 % to 19.93 billion from 17.73 billion	revenue rose 12 %
the market closed prior to mr. lawson 's announcement	the market closed prior
promises feng-hsiung hsu in three years we 'll mount a better challenge	promises feng-hsiung hsu we 'll mount a better challenge
seats are currently quoted at 430,000 bid and 525,000 asked	seats are currently quoted
the 30-share index settled 23.2 points higher at 1701.7	the 30-share index settled 23.2 points higher
revenue fell 1 % to 1.39 billion from 1.41 billion	revenue fell 1 %
it could do damage to us	it could do damage
but such caution is no guarantee against mistakes	but such caution is no guarantee
that 's another reason for the backer spielvogel job	that 's another reason
anyone telling you to buy stocks in this market is technically irresponsible	anyone telling you to buy stocks is technically irresponsible
the key word in that paragraph though is may	the key word though is may
expansion plans also include acquisitions in growing foreign markets	expansion plans also include acquisitions
given a choice everybody will watch a home-produced show	everybody will watch a home-produced show
the anticipated drop follows a 3.9 % rise in august	the anticipated drop follows a 3.9 % rise
some of the coal the plants buy will come from westmoreland mines	some will come
a cboe spokeswoman declined comment on petco	a cboe spokeswoman declined comment
i am determined to get an apartment in three years she says	i am determined to get an apartment she says
in new york the company declined comment	the company declined comment
i see it as a sewage treatment plant he says	i see it he says
turnover was also down substantially from 840.8 million shares on friday	turnover was also down substantially
cfcs are widely used as solvents coolants and fire suppressants	cfcs are widely used
at that time tasks were assigned strictly on the basis of seniority	tasks were assigned
budget said its frequent-flier costs are substantially below avis 's level	budget said its frequent-flier costs are
december silver eased 2.7 cents an ounce to 5.133	december silver eased 2.7 cents an ounce
the truth is washington understands politics better than economics	the truth is washington understands politics better
we could still have a recession at some point	we could still have a recession
mr. freeman is an executive vice president of american express	mr. freeman is an executive vice president
the atlanta-based chemical manufacturer said lower prices hurt margins for most products	the atlanta-based chemical manufacturer said lower prices hurt margins
the shares will be priced in early november she said	the shares will be priced she said
it depends on when you look	it depends
they could all fairly be described as pap courses	they could all fairly be described
santa fe also has 3.7 billion in debt	santa fe also has 3.7 billion
it did n't release terms of the transaction	it did n't release terms
an estimated 25.8 million is allocated to continue work in oman	an estimated 25.8 million is allocated to continue work
mr. dozen joined daiwa upon his graduation from kyoto university in 1959	mr. dozen joined daiwa
joseph w. robertson 61 was dismissed from those posts the company said	joseph w. robertson 61 was dismissed the company said
that effect holds true for both short-term and long-term bonds	that effect holds true
but they are also talking about new magazines	but they are also talking
for some time we had forecast negative third and fourth-quarter growth	we had forecast negative third and fourth-quarter growth
but going against the grain has never bothered mr. andersson	but going has never bothered mr. andersson
the money spent on repairs will be counted as a plus	the money spent will be counted
revenue rose 21 % to 22.61 billion francs from 18.69 billion francs	revenue rose 21 %
the issue was rated single-b-2 by moody 's and single-b by s&p	the issue was rated single-b-2 and single-b
it 's also a fast fix for an ailing image	it 's also a fast fix
the orange workers are just putting this preaching into practice	the orange workers are just putting this preaching
he also questioned whether recent gains in that country can be sustained	he also questioned whether recent gains can be sustained
this is one thing i was never aware of he says	this is one thing i was never aware he says
abc news has similarly branched out into entertainment gimmickry	abc news has similarly branched out
he reports his business is up slightly from customers replacing old stock	he reports his business is up slightly
revenue rose to 9.03 billion from 8.98 billion	revenue rose
mci traded as low as 41 3\/8 during the session	mci traded as low
inventories fell 0.3 % in august	inventories fell 0.3 %
it was the smallest monthly increase in a year	it was the smallest monthly increase
cathay officials decline to comment on the speculation	cathay officials decline to comment
the dam caused the water level to drop in zalubice	the dam caused the water level to drop
sotheby 's defends itself and mr. paul in the matter	sotheby 's defends itself and mr. paul
nestle s.a. is based in vevey switzerland	nestle s.a. is based
i feel sorry for whoever wins says a brazilian diplomat	i feel sorry says a brazilian diplomat
it was quoted at 2.9428 marks in late new york trading wednesday	it was quoted wednesday
the gruff financier recently started socializing in upper-class circles	the gruff financier recently started socializing
profit from continuing operations rose 19 %	profit rose 19 %
mr. cremonie 's firm once held about 4.8 % of h&r block	mr. cremonie 's firm once held about 4.8 %
anheuser-busch plunged 4 3\/8 to 38 1\/2 on 3.5 million shares	anheuser-busch plunged 4 3\/8
but i do n't want any of that oil for my grandkids	but i do n't want any
british sterling eased to 1.5775 from 1.5825	british sterling eased
if bluebloods wo n't pay high prices for racehorses anymore who will	if bluebloods wo n't pay high prices anymore who will
this bias is in no way deliberate	this bias is deliberate
the states have their own ideas about regulation and certification	the states have their own ideas
i suggest your reporter see charleston next spring in its full glory	i suggest your reporter see charleston next spring
the tax court is n't expected to rule before early next year	the tax court is n't expected to rule
the third principal in the south gardens adventure did have garden experience	the third principal did have garden experience
the company estimates its total debt at about 5.2 billion	the company estimates its total debt
i do n't think the market is going through another october '87	i do n't think the market is going
prices in brussels where a computer breakdown disrupted trading also tumbled	prices also tumbled
she serves high russian tea at 5 p.m	she serves high russian tea
say a big investor is interested in growth stocks	say a big investor is interested
unfortunately this problem continued even after gen. noriega 's indictment	unfortunately this problem continued
national leaders stopped by his stand to commend his achievements	national leaders stopped to commend his achievements
apartheid foes staged a massive anti-government rally in south africa	apartheid foes staged a massive anti-government rally
this past summer investors ' appetite for municipal bonds seemed insatiable	this past summer investors ' appetite seemed insatiable
sonet or synchronous optical network products have more capacity than earlier models	sonet or synchronous optical network products have more capacity
since then prices have slumped to an average of 395,374 this summer	prices have slumped
dan rather served as emcee	dan rather served
his dismissal triggered a furor among intellectuals that continues today	his dismissal triggered a furor that continues today
this heavy outside support for the worst has undermined better moderate leaders	this heavy outside support has undermined better moderate leaders
construction shares that gained included shimizu which rose 130 to 2,080	construction shares that gained included shimizu which rose 130
the rest is listed on spanish stock exchanges	the rest is listed
bofors admits payments of 41 million to middlemen	bofors admits payments
her instincts were capitalistic despite her background	her instincts were capitalistic
the voters delivered mr. gonzalez a third mandate for his successes	the voters delivered mr. gonzalez a third mandate
sales rose 2.9 % to 329.2 million from 320 million	sales rose 2.9 %
sales rose 8 % to 1.15 billion from 1.06 billion	sales rose 8 %
both regions are the fastest-growing areas for basf the company said	both regions are the fastest-growing areas the company said
worse her walls move all the time at least in this production	worse her walls move all the time
people showed some staying power and in fact interest in buying equities	people showed some staying power and interest
grumman corp. won a 58.9 million navy contract for 12 f-14 aircraft	grumman corp. won a 58.9 million navy contract
ual finally opened for trading at 10:08 a.m. at 150 down 28	ual finally opened down 28
people started wondering if something was wrong with him mr. miranda recalls	people started wondering if something was wrong mr. miranda recalls
sadly the cycle appears not as waves but as a downward spiral	sadly the cycle appears
sen. cohen said the relationship has reverted to its pre-reagan character	sen. cohen said the relationship has reverted
people are naturally suspicious of them says mr. mullins of morgan stanley	people are naturally suspicious says mr. mullins
anti-abortion forces regard him as at best an uncertain ally	anti-abortion forces regard him
sales declined 3 % to 524.5 million from 539.4 million	sales declined 3 %
mr. patel also was placed on three years ' probation	mr. patel also was placed
in most civil cases judges allow each side three such challenges	judges allow each side three such challenges
today of all days she lamented	today she lamented
with krenz we just do n't know what to expect	we just do n't know what to expect
alan murray contributed to this article	alan murray contributed
guaranteed by the south australian treasury	guaranteed
the percentage change is since year-end	the percentage change is
the loss came after a 23.3 million addition to loan-loss reserves	the loss came
paintings are just part of the picture	paintings are just part
the index is based on 1980 equaling 100	the index is based
intel eased 1\/8 to 31 7\/8	intel eased 1\/8
breeders are betting on the common folk	breeders are betting
pemex 's customers also are pleased with the company 's new spirit	pemex 's customers also are pleased
it settled with a loss of 4.95 cents at 1.3210 a pound	it settled
u.s. healthcare inc. was added to the health care providers group	u.s. healthcare inc. was added
the bonds are insured and rated triple-a by moody 's and s&p	the bonds are insured and rated triple-a
in this case the members outdid themselves	the members outdid themselves
now among communist reformers they are objects of envy	now they are objects
officials at carnival declined to comment	officials declined to comment
the old crowd is deeply concerned by the backlash from all this	the old crowd is deeply concerned
anne does n't believe in blandness said ms. smith	anne does n't believe said ms. smith
but some saw it as a classic negotiating tactic	but some saw it
japanese banks are under political pressure as well the analyst said	japanese banks are the analyst said
they root among the designer offerings at neiman-marcus and bullocks wilshire	they root
mr. roberts was assistant treasury secretary under president reagan	mr. roberts was assistant treasury secretary
at first it seemed as if history might repeat itself	it seemed as if history might repeat itself
revenue dropped 5.4 % to 3.48 billion from 3.68 billion	revenue dropped 5.4 %
the companies just gave back what they had reserved for he said	the companies just gave back what they had reserved he said
but he says he would prefer to get nominations from rank-and-file folks	but he says he would prefer to get nominations
reggie jackson the retired baseball star has found another use for them	reggie jackson the retired baseball star has found another use
a unified system of taxation should be introduced rapidly	a unified system should be introduced rapidly
the fasb had its initial meeting on march 28 1973	the fasb had its initial meeting
what happened friday was the worst of all worlds	what happened friday was the worst
many of the morning-session winners turned out to be losers by afternoon	many turned out to be losers
mr. lehman a reagan navy secretary is a managing director of painewebber	mr. lehman a reagan navy secretary is a managing director
the prices of most livestock futures contracts had dropped sharply monday	the prices had dropped sharply monday
drexel is owed 20 million by the partnership	drexel is owed 20 million
actually it was down only a few points at the time	actually it was down only a few points
battelle 's mr. mccall thinks steelmakers should concentrate more on construction	battelle 's mr. mccall thinks steelmakers should concentrate more
illinois company investments had been trimming its ranks until last summer	illinois company investments had been trimming its ranks
you do n't want to own anything long except gold stocks	you do n't want to own anything long
the two producers own a combined 28 % stake in guber-peters	the two producers own a combined 28 % stake
europe had proved even less hospitable than north america	europe had proved even less hospitable
operating revenue rose 69 % to 8.48 billion from 5.01 billion	operating revenue rose 69 %
smaller-stock earnings by comparison rose between 15 % and 20 %	smaller-stock earnings rose
the dow fell 22.6 % on black monday	the dow fell 22.6 %
slowing economies in some areas limit student choice	slowing economies limit student choice
the airline also named mickey foret as president	the airline also named mickey foret
stateswest serves 10 cities in california arizona and nevada	stateswest serves 10 cities
his recommendation was rejected by the government	his recommendation was rejected
in february mr. thornburgh announced his plan to abolish the units	mr. thornburgh announced his plan to abolish the units
the port of houston closed its terminal for handling bulk cargo	the port closed its terminal
but put her behind a shopping cart and she turns ruthless	but put her and she turns ruthless
there was n't any evidence of survivors	there was n't any evidence
i agree with mr. lehman 100 %	i agree 100 %
the fund invests mainly in gold and silver bullion	the fund invests mainly
chandler might have been predicting the course of his own career	chandler might have been predicting the course
for those who delight in the misfortune of others read on	read on
revenue rose to 1.5 billion from 1.1 billion	revenue rose
tradition is dictator at lloyd 's	tradition is dictator
the wind stinging with sand never seems to stop	the wind stinging never seems to stop
salespeople try to push their products and avoid discussions of finances	salespeople try to push their products and avoid discussions
it really brings you down to a human level she says	it really brings you she says
the eyes of the world were watching us	the eyes were watching us
that compared with 49 such transactions totaling 28.7 billion as year earlier	that compared
in the coming months however this is likely to change	however this is likely to change
it is fun competing as a private company mr. brawer says	it is fun competing mr. brawer says
the selection of mr. krenz may also disappoint moscow	the selection may also disappoint moscow
the carriers were competing fiercely for market share	the carriers were competing fiercely
it may experience an upswing or two in between	it may experience an upswing or two
however mr. krenz also has a reputation for being politically savvy	however mr. krenz also has a reputation
the market for electrochemicals include the paper water-purification and textile industries	the market include the paper water-purification and textile industries
new york city bonds have been beaten down for three straight weeks	new york city bonds have been beaten down
revenue rose 8.1 % to 23.65 billion from 21.88 billion	revenue rose 8.1 %
you go into them because they move counter to the general market	you go because they move counter
six months ago government approval for an anc rally was inconceivable	six months ago government approval was inconceivable
the acceptances give orkem a controlling 53.2 % stake in the company	the acceptances give orkem a controlling 53.2 % stake
agip already has an oil stake in libya	agip already has an oil stake
lloyd 's has endured decades of genteel decline	lloyd 's has endured decades
the irs will pay if its error burdens you with bank charges	the irs will pay if its error burdens you
we had a lot of problems mr. sinyard says	we had a lot mr. sinyard says
sony also agreed to indemnify the producers against any liability to warner	sony also agreed to indemnify the producers
security at a typical haagen inner-city center is impressive but unobtrusive	security is impressive but unobtrusive
in january mr. salvatori sold the unit	mr. salvatori sold the unit
ms. rose is best on the early years and world war ii	ms. rose is best
the ground shakes underneath her	the ground shakes
at applied mr. sim set growth as his first objective	mr. sim set growth
the offering series 109 is backed by freddie mac 10 % securities	the offering series 109 is backed
mr. carey will remain a member of the merchant bank 's board	mr. carey will remain a member
that was slightly above sotheby 's presale estimate of 111 million	that was
and the poles are engaged in commerce	and the poles are engaged
that will please once-grumpy affiliates another aim of the pilson plan	that will please once-grumpy affiliates another aim
on balance we think it will be positive	we think it will be positive
the first five leased units were to be delivered in 1991	the first five leased units were to be delivered
some u.s. entrepreneurs operate on a smaller scale	some u.s. entrepreneurs operate
compare p\/e ratios with prospects	compare p\/e ratios
occupational-urgent care health fell 1 3\/4 to 15 1\/2 on 354,000 shares	occupational-urgent care health fell 1 3\/4
essentially the critics of stock-index futures fall into two camps	essentially the critics fall
otherwise actual profit is compared with the 300-day estimate	otherwise actual profit is compared
a hundred billion dollars in stock was subject to it	a hundred billion dollars was subject
but the lack of lines became painfully apparent	but the lack became painfully apparent
he also reaffirmed east germany 's allegiance to communist orthodoxy	he also reaffirmed east germany 's allegiance
revenue was about flat at 2.4 billion	revenue was about flat
paul l. kane laurel 's president at the time quickly responded	paul l. kane laurel 's president quickly responded
by contrast traditional buy-and-hold investors are unlikely to generate sudden price moves	traditional buy-and-hold investors are unlikely to generate sudden price moves
marshall 's ghost is satisfied for now but he 'll be back	marshall 's ghost is satisfied but he 'll be back
that 's the dilemma for today 's parent	that 's the dilemma
merabank 's rating for short-term deposits remains not prime	merabank 's rating remains not prime
it was the opposite of what happened on oct. 19	it was the opposite
feeling the naggings of a culture imperative i promptly signed up	feeling the naggings i promptly signed up
the 30-share index ended 12.6 points higher at 1751.9	the 30-share index ended 12.6 points higher
however on balance the charity game helps america	however the charity game helps america
first interstate made the move under pressure from regulators	first interstate made the move
let this building be steppenwolf 's legacy to chicago theater	let this building be steppenwolf 's legacy
this expected blow has cast a pall over the economy 's prospects	this expected blow has cast a pall
died cornel wilde 74 actor and director in los angeles of leukemia	died cornel wilde 74 actor and director
the city could lose some of its entrepreneurial flavor	the city could lose some
terms of the agreement were n't given	terms were n't given
fuel costs were up 10 % in the third quarter	fuel costs were up 10 %
miss shlaes is editorial features editor of the wall street journal\/europe	miss shlaes is editorial features editor
mr. rey says the move is yet another example of his conservatism	mr. rey says the move is yet another example
hotel-casino operators play down the possibility of a labor shortage	hotel-casino operators play down the possibility
avco corp. received an 11.8 million army contract for helicopter engines	avco corp. received an 11.8 million army contract
and the total amount of junk financing will be reduced	and the total amount will be reduced
kajima advanced 40 to 2,120 and ohbayashi added 50 to 1,730	kajima advanced 40 and ohbayashi added 50
in major market activity stock prices slumped in sluggish trading	stock prices slumped
the judge they say was fiercely proud of his abilities and accomplishments	the judge they say was fiercely proud
cbs may remain a distant no. 3 in that regard	cbs may remain a distant no. 3
sales grew almost 7 % to 279.1 million from 261.3 million	sales grew almost 7 %
the december contract rose 1.50 cents a pound to 1.2795	the december contract rose 1.50 cents a pound
many of his peers feel the same way	many feel the same way
what did he think of the supreme court 's decision legalizing abortion	what did he think
columbia announced the results after the close of the stock market	columbia announced the results
you 'll see the annual unraveling of it	you 'll see the annual unraveling
the offer is scheduled to expire on nov. 28 unless extended	the offer is scheduled to expire unless extended
there was a unique combination in 1987 he says	there was a unique combination he says
now the question is is poland ready for it	now the question is is poland ready
some even see a silver lining in the dark clouds	some even see a silver lining
they 've now adapted the yeast to making genetically engineered drugs	they 've now adapted the yeast
revenue increased 7.5 % to 540.9 million from 503.1 million	revenue increased 7.5 %
i 'm out of bed	i 'm
we 're close to the bottom of the near-term ranges she contends	we 're close she contends
officials at the washington d.c.-based charity did n't return repeated phone calls	officials did n't return repeated phone calls
of the almost 3,000 athletes surveyed 1,240 took the time to respond	1,240 took the time to respond
mrs. brown calls the modern-day cultural ambivalence to filipino a language schizophrenia	mrs. brown calls the modern-day cultural ambivalence a language schizophrenia
once they are in the building they stay	once they are they stay
this untried concept would expose these firms to potentially astronomical punitive damages	this untried concept would expose these firms
by starving the peasant the communists have starved poland	the communists have starved poland
opponents of the cut are playing hardball	opponents are playing hardball
fiscal first-half sales slipped 3.9 % to 528.4 million from 549.9 million	fiscal first-half sales slipped 3.9 %
the record price for associate membership is 275,000 set aug. 30 1988	the record price is 275,000 set aug. 30 1988
commercial intertech plummeted 6 to 26	commercial intertech plummeted 6
cautious investors should generally go with stocks that have low betas	cautious investors should generally go
sales rose 12 % to 249.5 million from 222.8 million	sales rose 12 %
now she says she 's thinking of contacting her own insurance agent	now she says she 's thinking
i would like to go back to 1970	i would like to go back
other analysts are nearly as pessimistic	other analysts are
a capital-gains tax cut plan has been worked out by senate republicans	a capital-gains tax cut plan has been worked out
one was so fantastic in appearance it was dubbed hallucigenia	one was so fantastic it was dubbed hallucigenia
employers casualty had a loss of 3.6 million in the year-earlier quarter	employers casualty had a loss
a big reason for the chemical price retreat is overexpansion	a big reason is overexpansion
the company could command a good price in the market	the company could command a good price
the close was the highest since aug. 15	the close was the highest
volume was estimated at 800 million shares compared with 678 million tuesday	volume was estimated
some wall street firms monitor for recordkeeping purposes	some wall street firms monitor
the poles might do better to view it as a trojan horse	the poles might do better to view it
that 's not what our fathers had in mind	that 's not what our fathers had
or call it the wave of the future	or call it the wave
but mr. corr 's tenure was shorter than most	but mr. corr 's tenure was shorter
brokers agreed with the two-tier price theory	brokers agreed
honeywell said a second sale of yamatake-honeywell is still being negotiated	honeywell said a second sale is still being negotiated
fortunately volunteers and charities are not motivated by self-interest but by altruism	fortunately volunteers and charities are not motivated
hewlett-packard is based in palo alto calif	hewlett-packard is based
revenue rose 6 % to 2.79 billion from 2.63 billion	revenue rose 6 %
the machine began shipping at the end of last year	the machine began shipping
in five minutes the dow industrials climbed almost 30 points	the dow industrials climbed almost 30 points
no foreign companies bid on the hiroshima project according to the bureau	no foreign companies bid
lloyd 's only recently reported its financial results for 1986	lloyd 's only recently reported its financial results
its plan is set up as an independent agency	its plan is set up
they promised yet more for really good stuff	they promised yet more
the companies hope for a final agreement by year-end	the companies hope
in general they say avoid takeover stocks	they say avoid takeover stocks
by 1980 there were more than 100 such funds	there were more than 100 such funds
since march exports have been virtually flat	exports have been virtually flat
profits of franchisees have n't been higher since the mid-1970s he adds	profits have n't been higher he adds
sales rose 11 % to 7.73 billion from 6.94 billion	sales rose 11 %
meanwhile overall evidence on the economy remains fairly clouded	meanwhile overall evidence remains fairly clouded
meanwhile at home mitsubishi has control of some major projects	meanwhile mitsubishi has control
their verdict on real estate is almost the same	their verdict is almost the same
dr. dryja made his retinoblastoma discovery in 1986	dr. dryja made his retinoblastoma discovery
nasdaq 's gain was led by its biggest industrial stocks	nasdaq 's gain was led
dwg is a holding company controlled by mr. posner	dwg is a holding company controlled
it also sells single-premium annuities to individuals	it also sells single-premium annuities
net fell 1 % to 3.23 billion yen from 3.26 billion yen	net fell 1 %
sandwiched between desks underwriters sit on benches surrounded by stacks of policies	sandwiched underwriters sit
milton roy jumped 2 to 18 3\/8	milton roy jumped 2
i would view it as a net positive	i would view it
it did shaking the apple establishment to its roots	it did shaking the apple establishment
he also received 20-year sentences for each of the 24 passengers injured	he also received 20-year sentences
of 1,500 people sent a questionnaire 951 replied	951 replied
the merger is scheduled to take place in the 1990 first quarter	the merger is scheduled to take place
they are often closed to the public and no minutes are taken	they are often closed and no minutes are taken
that 's well above what bonds or bank certificates have paid	that 's
the quake postponed the third and fourth games of the world series	the quake postponed the third and fourth games
it is considered an early signal of fed credit policy changes	it is considered an early signal
at that rate the defense plan is underfunded by 48 billion	the defense plan is underfunded
moreover much investment is n't aimed at increasing capacity	moreover much investment is n't aimed
you ca n't live on that	you ca n't live
behind the silly posturing lies a real dispute	lies a real dispute
in tokyo stocks closed lower but above intraday lows in active trading	stocks closed lower but above intraday lows
revenue declined 3.4 % to 8.4 billion from 8.7 billion	revenue declined 3.4 %
sales rose 6.7 % to 4.27 billion from 4 billion	sales rose 6.7 %
for nonunion workers the costs rose 1.4 %	the costs rose 1.4 %
such animosity could prove pivotal in the union vote	such animosity could prove pivotal
the tva 's public debt offering was its first in 15 years	the tva 's public debt offering was its first
we watch the same indicators and listen to the same prognosticators	we watch the same indicators and listen
we cruise toward another set of pilings	we cruise
the usual warning signs of hypoglycemia include sweating anxiety and cramps	the usual warning signs include sweating anxiety and cramps
there is a simple reason for this the cuban people	there is a simple reason the cuban people
those rights prevent anyone other than revco from proposing a reorganization plan	those rights prevent anyone other
craig torres and anne newman contributed to this article	craig torres and anne newman contributed
at the end of the day 251.2 million shares were traded	251.2 million shares were traded
in major market activity treasury bond prices fell	treasury bond prices fell
these are the raw materials used in making plastics	these are the raw materials used
rounding-off keeps them at 1	rounding-off keeps them
ciba-geigy is a major pharmaceutical concern based in basel switzerland	ciba-geigy is a major pharmaceutical concern based
examples are ford looking at jaguar bellsouth looking at lin broadcasting	examples are ford looking bellsouth looking
the transaction is expected to close around year end	the transaction is expected to close
sales rose 50 % to 2.1 billion from 1.4 billion	sales rose 50 %
mrs. thi did n't wait for the reforms to get her start	mrs. thi did n't wait to get her start
about 800 have crossed the picket lines and returned to work	about 800 have crossed the picket lines and returned
mandela considered the most prominent leader of the anc remains in prison	mandela considered the most prominent leader remains
and they are quietly linking up with u.s. publishing trade groups	and they are quietly linking up
revenue rose 40 % to 13.32 billion francs from 9.53 billion	revenue rose 40 %
sales fell 1.2 % to 190.1 million from 192.5 million	sales fell 1.2 %
why should i be part of that problem	why should i be part
cnbc is available to 13 million cable households	cnbc is available
mr. koenig said i just got a tremendous offer from gruntal	mr. koenig said i just got a tremendous offer
but the deal fell apart last week for lack of financing	but the deal fell apart last week
they ca n't afford to stay out of hdtv	they ca n't afford to stay out
the 30-share index settled 42.0 points lower at 1678.5	the 30-share index settled 42.0 points lower
revenue was flat at about 2.97 billion	revenue was flat
damage will be easily in the millions the company said	damage will be easily the company said
shell eased 1 to 416 on turnover of 4.8 million shares	shell eased 1
companies seeking to make insurers pay for pollution cleanup win court victory	companies seeking to make insurers pay win court victory
the consumer price index climbed 4.3 % in the same period	the consumer price index climbed 4.3 %
in our formula we do n't have any losers except the competition	we do n't have any losers
now it 's dawning on them that they can be non-wealthy	now it 's dawning that they can be non-wealthy
output of business equipment was unchanged in september	output was unchanged
a decision on that case is n't expected before mid-november	a decision is n't expected
in national over-the-counter trading yesterday bsb closed at 17.50 up 12.5 cents	yesterday bsb closed up 12.5 cents
i do n't like the sound of that	i do n't like the sound
silicon valley heaved a sigh of relief yesterday	silicon valley heaved a sigh yesterday
that trend could increase demand for hot-dipped galvanized sheet	that trend could increase demand
the beebes alleged that toxic fumes from the carpets made them sick	the beebes alleged that toxic fumes made them sick
the american stock exchange listed shares of two companies	the american stock exchange listed shares
mortgage securities ended little changed after light dealings	mortgage securities ended little changed
you know what the law of averages is do n't you	you know what the law is do n't you
pressure came from several developments including the settlement of two long-term strikes	pressure came
total revenue reached 2.83 billion up 10 % from 2.57 billion	total revenue reached 2.83 billion up 10 %
since 1981 indian military advisers have been assisting the kabul regime	indian military advisers have been assisting the kabul regime
lack of liquidity can also result from exchange reforms	lack can also result
lone star 's san francisco facilities were n't damaged in the quake	lone star 's san francisco facilities were n't damaged
we have one near here	we have one
and that puts added pressure on chez panisse dessert-menu planners	and that puts added pressure
until recently such buy-now pray-for-growth-later deals were routine	such buy-now pray-for-growth-later deals were routine
then they identified snags in the process	then they identified snags
housing starts sank 5.2 % in september to a seven-year low	housing starts sank 5.2 %
blue-chip consumer stocks also provided a lift to the industrial average	blue-chip consumer stocks also provided a lift
all the concerns are based in toronto	all the concerns are based
dozens of small companies did swiftly establishing a standard operating system	dozens did swiftly establishing a standard operating system
the two companies later agreed to settle for 95 million	the two companies later agreed to settle
but they did n't lose touch with the u.s. issuers	but they did n't lose touch
the scientists have experimented on the tiny neck arteries of rats	the scientists have experimented
and he nearly always bought and sold for cash	and he nearly always bought and sold
average daily volume in s&p 500 futures last year was 44,877 contracts	average daily volume last year was 44,877 contracts
in broadest terms stability has quietly settled into international oil markets	stability has quietly settled
for months the resistance has been defenseless against air attack	the resistance has been defenseless
ag is hardly alone in its anxiety	ag is hardly alone
yield on the issue was 7.88 %	yield was 7.88 %
without machines good farms ca n't get bigger	good farms ca n't get bigger
the board increased to 11 seats	the board increased
poland is short on enterprises not enterprise	poland is short
sperry merged with burroughs corp. to become unisys corp. in late 1986	sperry merged to become unisys corp.
at 12:49 p.m. the index hit its low 2029.7 off 204.2 points	the index hit its low 2029.7 off 204.2 points
sales rose 2.6 % to 1.32 billion from 1.29 billion	sales rose 2.6 %
if the whole story were told it would read something like this	if the whole story were told it would read something
xerox fell 3 1\/8 to 59 5\/8	xerox fell 3 1\/8
help may be on the way	help may be
the dow jones industrial average fell 26.23 points to 2662.91	the dow jones industrial average fell 26.23 points
inco shares fell after the announcements	inco shares fell
addison is no stranger to cans of worms either	addison is no stranger either
yields on most fixed-income securities are lower than several months ago	yields are lower
everybody was afraid of him mr. ingersoll says	everybody was afraid mr. ingersoll says
living there for six years was really scary	living there was really scary
historically new york is almost always in trouble	historically new york is almost always
during that time control data had losses of more than 1 billion	control data had losses
the farmers ran a boycott and meat disappeared from the shops	the farmers ran a boycott and meat disappeared
i tell people it 's the groundup bones of saints he says	i tell people it 's the groundup bones he says
he reset opening arguments for today	he reset opening arguments
in los angeles in our lean years we gave parties	we gave parties
the cost of competition has become extremely high he says	the cost has become extremely high he says
mr. semel in his affidavit does n't mention any hugging or congratulating	mr. semel does n't mention any hugging or congratulating
intermec a maker of optical character-recognition devices also reported higher third-quarter earnings	intermec a maker also reported higher third-quarter earnings
the public is very close to having had it mr. jenks says	the public is very close mr. jenks says
evidence of the growing japanese demand for mortgage securities abounds	evidence abounds
the computers will display stock prices selected by users	the computers will display stock prices selected
cra is 49%-owned by rtz corp. of britain	cra is 49%-owned
the rest were withdrawn for lack of acceptable bids	the rest were withdrawn
mr. stein was fined 25,000 and suspended for three years	mr. stein was fined 25,000 and suspended
i think the market is in good shape	i think the market is
rival gangs have turned cities into combat zones	rival gangs have turned cities
uneasiness about wall street was cited in several markets	uneasiness was cited
closely held automax has annual sales of about 10 million	closely held automax has annual sales
the 942,000 purchase raised his holdings to 74,000 shares	the 942,000 purchase raised his holdings
he did n't rule out negotiations with ford however	he did n't rule out negotiations however
he made his remarks to a plo gathering in baghdad	he made his remarks
they came by their strangeness honestly	they came honestly
sterling was unchanged at 1.5753	sterling was unchanged
the market closed minutes after reaching its high for the day of	the market closed minutes
it also raised hackles of the city 's tourism boosters	it also raised hackles
mrs. marcos 's trial is expected to begin in march	mrs. marcos 's trial is expected to begin
the percentage change is since year-end	the percentage change is
seats currently are quoted at 361,000 bid 395,000 asked	seats currently are quoted
sales rose to 8.19 billion from 7.65 billion	sales rose
pepsico closed at 58.50 a share up 1.375	pepsico closed up 1.375
revenues rose 8.8 % to 4.35 billion from 4.0 billion	revenues rose 8.8 %
sales soared 28 % to 15.43 billion from 12.09 billion	sales soared 28 %
the latest period had profit from continuing operations of 4 million	the latest period had profit
they 're really fashion items wrapped up in little jars	they 're really fashion items wrapped up
it blames most of these on fatah	it blames most
he wants to recover more than just his property though	he wants to recover more though
they are nonetheless high on manville 's management	they are nonetheless high
the deadbeats are still deadbeats said mr. feinman of drexel	the deadbeats are still deadbeats said mr. feinman
las vegas has seen nothing quite like it before	las vegas has seen nothing before
i would like to issue a challenge to corporate america	i would like to issue a challenge
that perception takes the focus off the magazine	that perception takes the focus
that contract was tied to the success of the buy-out	that contract was tied
some would make even james bond green with envy	some would make even james bond green
assets soared 4.5 billion in the previous week	assets soared 4.5 billion
the american stock exchange market value index fell 0.44 to 375.92	the american stock exchange market value index fell 0.44
climate varies drastically due to natural causes said mr. thompson	climate varies drastically due said mr. thompson
you built your career on prejudice and hate	you built your career
mr. ely 57 years old temporarily increases the board to seven members	mr. ely 57 years old temporarily increases the board
nonsense she told an interviewer yesterday on london weekend television	nonsense she told an interviewer yesterday
it has won about 15 % of the retail pc market	it has won about 15 %
during one recent episode all the advertisements were in english	all the advertisements were
iras were like stepchildren there	iras were there
the combined company would have had 1988 sales of 13.1 billion	the combined company would have had 1988 sales
treasury prices ended mixed in light trading	treasury prices ended mixed
he said unfavorable currency translations were also a factor in the quarter	he said unfavorable currency translations were also a factor
intra-european takeovers are expected to continue at their brisk pace	intra-european takeovers are expected to continue
earnings have rebounded in 1989 after a 20 % decline last year	earnings have rebounded
step up to the plate and take the big swing	step up and take the big swing
gradually a coherent picture of cancer development emerged	gradually a coherent picture emerged
the company expects to resume full operations by today	the company expects to resume full operations
their machine tools are even bolted to the shop floor	their machine tools are even bolted
neatness does count at least in the grocery store	neatness does count
that figure has been inching up for several years	that figure has been inching up
thus he asserts lloyd 's ca n't react quickly to competition	thus he asserts lloyd 's ca n't react quickly
treasury securities were essentially flat to about 1\/2 point lower	treasury securities were essentially flat
the matter may never even be tried in court	the matter may never even be tried
could the collapse of i-880 have been prevented	could the collapse have been prevented
to get the khmer rouge as part of a process for elections	to get the khmer rouge
the result is mistrust and criticism from all around	the result is mistrust and criticism
then they said by the way two of the doors are locked	then they said two are locked
the latest rebate is good for all beretta models	the latest rebate is good
all the figures are adjusted for seasonal variations	all the figures are adjusted
his boss complained about neglect of other chores	his boss complained
we 're just seeing the beginning of a shift mr. smith says	we 're just seeing the beginning mr. smith says
the august drop was the fourth decline in five months	the august drop was the fourth decline
the volatility was dizzying for traders	the volatility was dizzying
london 's financial times-stock exchange 100-share index fell 27.9 points to 2135.5	london 's financial times-stock exchange 100-share index fell 27.9 points
dwg corp. jumped 1 1\/4 to 15 on 454,100 shares	dwg corp. jumped 1 1\/4
solidarity wants it from the west	solidarity wants it
sales rose 6 % to 2.77 billion from 2.61 billion	sales rose 6 %
if there is no law against it do it	if there is no law do it
south carolina deserves an a for its quick and timely relief efforts	south carolina deserves an a
jeanene page of north salt lake city utah likes the broader selection	jeanene page likes the broader selection
he had been group vice president of the electronic-publishing group	he had been group vice president
by 1986 the number of federal regulators was down to about 103,000	the number was down
it is known in the pentagon as the negative wedge	it is known
some have been combined into suites for the high rollers	some have been combined
that was offset by strength elsewhere	that was offset
this kind of theater was new to us	this kind was new
but traders who risk money handling big blocks of stock were shaken	but traders who risk money handling big blocks were shaken
usair and mr. buffett wo n't talk about mr. steinhardt at all	usair and mr. buffett wo n't talk at all
her story is becoming part of local folklore	her story is becoming part
mr. kim of j. walter thompson does n't think so	mr. kim does n't think so
rally 's inc. a louisville ky. restaurant franchisor started trading under rlly	rally 's inc. a louisville ky. restaurant franchisor started trading
back in 1964 the fbi had five black agents	the fbi had five black agents
this news raised hopes for further interest-rate cuts	this news raised hopes
power failures kept just seven of its 1,500 automated-teller machines off-line	power failures kept just seven off-line
what tongue to speak is an emotional mine field in the philippines	what tongue to speak is an emotional mine field
but then the noise turned into a roar	but then the noise turned
things work out unexpectedly in life said ms. volokh	things work out unexpectedly said ms. volokh
the infusion of activists can bring a clash of cultures	the infusion can bring a clash
i feel better than i ever have in my life he says	i feel better than i ever have he says
the suit 's impact on new york may be narrow however	the suit 's impact may be narrow however
a manville spokesman would n't elaborate on the proposed changes	a manville spokesman would n't elaborate
computer companies commodity cyclical stocks like autos and retailing stocks he says	computer companies commodity cyclical stocks and retailing stocks he says
aftereffects of the 1987 stock market crash head the list of reasons	aftereffects head the list
the group is divided primarily between software semiconductors and computers	the group is divided primarily
we certainly see an increasing trend toward that she added	we certainly see an increasing trend she added
his election increases ryder 's board to 14 members	his election increases ryder 's board
mr. fedders is philosophical about his travails	mr. fedders is philosophical
in addition unisys must deal with its increasingly oppressive debt load	unisys must deal
shearson is about 60%-held by american express co	shearson is about 60%-held
paris loved her at first sight	paris loved her
they value mccaw 's bid at 112 to 118 a share	they value mccaw 's bid
baker had lots of them	baker had lots
revenue for fiscal 1989 is expected to exceed 124 million	revenue is expected to exceed 124 million
in mr. luzon 's first year the bank eliminated 800 jobs	the bank eliminated 800 jobs
mr. goldberg is the sole general partner in rose partners	mr. goldberg is the sole general partner
i will hereafter devote myself to serving him	i will hereafter devote myself
gsx is a unit of laidlaw transportation ltd. of burlington canada	gsx is a unit
he 's written this book the art of the deal	he 's written this book the art
mr. blair and hees have been feuding for months	mr. blair and hees have been feuding
and the investigators were quickly closing in on mr. noriega himself	and the investigators were quickly closing in
sales fell to 981.2 million from 1.02 billion	sales fell
once again the company 's future looked less than rosy	once again the company 's future looked less
the year-ago results have been restated to comply with government regulations	the year-ago results have been restated to comply
in chicago for example size is the issue	size is the issue
mr. maynard recently fell from a horse and fractured his arm	mr. maynard recently fell and fractured his arm
his humility gives him a much better chance of success	his humility gives him a much better chance
for the prior year deposits exceeded withdrawals by 8.8 billion	deposits exceeded withdrawals
tuesday the shares regained skr20 closing at skr225	tuesday the shares regained skr20 closing
surveys suggested that consumer confidence was high before friday	surveys suggested that consumer confidence was high
it was like driving down the highway watching a wreck	it was
the issue has an expected final maturity date of 1998	the issue has an expected final maturity date
scientists also are exploring memory and perception with the new machines	scientists also are exploring memory and perception
it recently introduced a line for the home market	it recently introduced a line
we think everything will go this way in a few years	we think everything will go this way
it was only a matter of time	it was only a matter
all parts of the issue are callable at any time at par	all parts are callable
small-lot buying targeted at incentive-backed issues pushed up the nikkei	small-lot buying targeted pushed up the nikkei
revenue declined 518 million to 13.63 billion	revenue declined 518 million
but the scope of seagram 's chivas promotion sets it apart	but the scope sets it apart
as of sept. 30 american brands had 95.2 million shares outstanding	american brands had 95.2 million shares outstanding
already congress is toying with legislation to curb the fed 's independence	already congress is toying
i got out in 1987	i got out
in new york stock exchange composite trading dayton rose 1 to 61.125	dayton rose 1
unilever wo n't comment schering however denies the brand is for sale	unilever wo n't comment schering however denies the brand is
accepted bids ranged from 8 % to 8.019 %	accepted bids ranged
springs industries dropped 1 3\/8 to 36	springs industries dropped 1 3\/8
robert crandall with the brookings institute agrees	robert crandall agrees
mr. rezneck is a lawyer in washington d.c	mr. rezneck is a lawyer
and real estate usually has n't traded well under public ownership	and real estate usually has n't traded well
the withdrawals could spell trouble for the 200 billion junk market	the withdrawals could spell trouble
but i was n't ready for a career at that time	but i was n't ready
officials of ps of new hampshire could n't be reached for comment	officials could n't be reached
the company says those holdings constitute the third-biggest real-estate portfolio in belgium	the company says those holdings constitute the third-biggest real-estate portfolio
that would cut into cbs 's slim margin for profit and error	that would cut
but a majority of the addison council did n't buy those arguments	but a majority did n't buy those arguments
nothing less it seemed could console them for their traumas	nothing less it seemed could console them
along the way there also are lots of romantic dalliances	there also are lots
that amounts to more than 350 billion a year	that amounts
these securities are attractive to japanese investors for three reasons	these securities are attractive
revenue rose 12 % to 1.63 billion from 1.46 billion	revenue rose 12 %
monday and tuesday were lackluster in comparison he said	monday and tuesday were lackluster he said
look at dostoevski and kafka	look
the british shakeup was widely cited for the declines	the british shakeup was widely cited
after cooling the coins are then rewrapped	the coins are then rewrapped
christmas shoppers find a helping hand from some catalog companies	christmas shoppers find a helping hand
nick cortese thinks that 's what happened to him	nick cortese thinks that 's what happened
dow jones & co. announced wall street journal advertising rates for 1990	dow jones & co. announced wall street journal advertising rates
short selling is n't necessarily bad for the overall market	short selling is n't necessarily bad
the selling that started on friday continued yesterday	the selling that started continued yesterday
people are shooting for a dream	people are shooting
everybody was trying to do the same thing at the same time	everybody was trying to do the same thing
the nasdaq composite index surged 4.26 or about 0.94 % to 455.63	the nasdaq composite index surged 4.26 or about 0.94 %
probably the most clear-cut soviet violation for example is the krasnoyarsk radar	probably the most clear-cut soviet violation is the krasnoyarsk radar
federal revenues rose 9 % to 990.79 billion	federal revenues rose 9 %
says mr. steidtmann i 'm looking for a bi-polar christmas	says mr. steidtmann i 'm looking
weisfield 's had about 1.1 million shares outstanding as of july 31	weisfield 's had about 1.1 million shares outstanding
other firms are dealing with the masses	other firms are dealing
they estimate the value of the transaction at close to 100 million	they estimate the value
there is no rational justification for such behavior	there is no rational justification
a 35-nation environmental conference opened in sofia bulgaria	a 35-nation environmental conference opened
revenues were 99.23 billion up from 97.74 billion a year earlier	revenues were 99.23 billion up
freddie mac 's 9 % issue ended at 97 19\/32 up 2\/32	freddie mac 's 9 % issue ended up 2\/32
hanson with 15 million shares traded closed 2.5 lower at 212.5	hanson closed 2.5 lower
at the time the merksamer chain had 11 stores in operation	the merksamer chain had 11 stores
some auto executives believe the benefits of more choice outweigh the drawbacks	some auto executives believe the benefits outweigh the drawbacks
for there is an emerging protocol indeed an etiquette to it	for there is an emerging protocol indeed an etiquette
mccormick is a developer and manager of futures-investment limited partnerships	mccormick is a developer and manager
the flight was rescheduled for today	the flight was rescheduled
backlog at general dynamics rose to 16.5 billion from 15.8 billion	backlog rose
the unions and the company last week agreed to mediation	the unions and the company last week agreed
he probably has n't done it for the cash	he probably has n't done it
the charter was approved by the ec commission on sept. 21	the charter was approved
sales rose 2.9 % to 827.9 million from 804.3 million	sales rose 2.9 %
one might well ask why bother with this drug at all	one might well ask why bother at all
by one estimate everyone here under 50 owns at least one bike	everyone here owns at least one bike
the company focuses on the how-to aspects says andrew e. philip president	the company focuses says andrew e. philip president
apparently they are learning to say no to excess risk	apparently they are learning to say no
caere was underwritten by alex brown & sons	caere was underwritten
stockholders will vote on the proposal at a meeting dec. 13	stockholders will vote dec. 13
however inflation for 1990 was seen slowing to 4.5 %	however inflation was seen slowing
continental airlines is a unit of texas air corp	continental airlines is a unit
without legal recourse there are no guarantees of civil rights for anyone	there are no guarantees
roughly a third of the charities reviewed flunk the test	roughly a third flunk the test
with less capital coming in china 's balance of payments would suffer	china 's balance would suffer
following that announcement tuesday however company officials were unavailable to elaborate	however company officials were unavailable to elaborate
those percentages hardly changed from the previous year 's poll	those percentages hardly changed
this activity produced small rallies which in turn attracted new short selling	this activity produced small rallies which attracted new short selling
they note that stocks experienced volatile swings long before futures	they note that stocks experienced volatile swings
the company is active in office and residential development in new york	the company is active
the panamanian affair is only the tip of a more alarming iceberg	the panamanian affair is only the tip
will ogonyok begin a series of reports analyzing the failures of perestroika	will ogonyok begin a series
revenue rose 7.6 % to 12.97 billion from 12.05 billion	revenue rose 7.6 %
the number includes such unstylish burgs as well oakland	the number includes such unstylish burgs
giants fans went into euphoria says mr. engelken	giants fans went says mr. engelken
the warrants may be exercised until 90 days after their issue date	the warrants may be exercised
the two sides were scheduled to meet with the mediator this morning	the two sides were scheduled to meet this morning
this legislation was not drafted by a handful of democratic do-gooders	this legislation was not drafted
other fundamental reforms of the 1986 act have been threatened as well	other fundamental reforms have been threatened as well
in 1986 congress strengthened the penalty by making it a felony	congress strengthened the penalty
of course that was before ford 's latest move	that was
emc manufactures data-storage systems for mainframes and minicomputers	emc manufactures data-storage systems
mr. beddall had been executive vice president of the division since april	mr. beddall had been executive vice president
that should happen by today he said	that should happen he said
mr. ehrlich will continue as a director and a consultant	mr. ehrlich will continue
the spokesman said unocal has had considerable interest from prospective buyers	the spokesman said unocal has had considerable interest
should they too stop messing with his free market	should they too stop messing
the 150,000-square-foot plant will be constructed on a 55-acre site near dublin	the 150,000-square-foot plant will be constructed
gray was advised by goldman sachs and merrill lynch	gray was advised
no individuals were charged in the indictment	no individuals were charged
that committee determined to open arizona to banking across state lines	that committee determined to open arizona
sterling was quoted at 1.6030 up from 1.5885 late friday	sterling was quoted up
mccaw lost 8 % or 3 1\/2 to 40	mccaw lost 8 % or 3 1\/2
ge capital has a working relationship with l.j. hooker	ge capital has a working relationship
shorted shares must eventually be replaced through buying	shorted shares must eventually be replaced
in addition mccall 's put in a less than stellar performance	mccall 's put in a less than stellar performance
the elections are set for nov. 7	the elections are set
taken by surprise the socialist party is busy changing its doctrines	taken the socialist party is busy changing its doctrines
quarterly revenue rose 4.5 % to 2.3 billion from 2.2 billion	quarterly revenue rose 4.5 %
had the case gone to trial the same issues would have surfaced	had the case gone the same issues would have surfaced
risc technology speeds up a computer by simplifying the internal software	risc technology speeds up a computer
mothers of young aids patients expressed somber satisfaction	mothers expressed somber satisfaction
elsewhere share prices closed lower in zurich amsterdam milan and stockholm	elsewhere share prices closed lower
the pool invested idle cash for many state agencies and local governments	the pool invested idle cash
a hearing is scheduled on the issue today	a hearing is scheduled today
the transaction would mark the entry of p&g into cosmetics	the transaction would mark the entry
i thought back to our time in small sparsely populated communities	i thought back
stock prices rallied in active trading	stock prices rallied
world-wide production would be cut in half by 1998	world-wide production would be cut
in addition delmed is exploring distribution arrangements with fresenius usa delmed said	delmed is exploring distribution arrangements delmed said
keeping the listed price at a dollar is primarily a convenience	keeping the listed price is primarily a convenience
but there are grounds for complaint	but there are grounds
the janus group had a similar recording for investors	the janus group had a similar recording
at that point investors may face a long bumpy ride	investors may face a long bumpy ride
now that 's advice the writers should take to heart	now that 's advice the writers should take
mr. dinkins concedes nothing in his ability to stumble and bumble	mr. dinkins concedes nothing
macmillan has owned berlitz since 1966	macmillan has owned berlitz
much is being done in colombia to fight the drug cartel mafia	much is being done to fight the drug cartel mafia
easy eggs are pasteurized in a heat-using process	easy eggs are pasteurized
he says his son has n't paid for the shares	he says his son has n't paid
by move 21 d.t. had fallen into a deep positional trap	d.t. had fallen
revenue slipped 0.7 % to 395.3 million from 398.3 million	revenue slipped 0.7 %
in 1982 he started a factory in greece	he started a factory
a spokesman for ge capital declined to comment	a spokesman declined to comment
profit from continuing operations in the year-earlier period was 402.7 million	profit was 402.7 million
a crusade of no to the consumption of drugs is imperative	a crusade is imperative
that puts pressure on cd rates	that puts pressure
december delivery gold fell 1.80 an ounce to 370.60	december delivery gold fell 1.80 an ounce
he does n't just walk off the mound and weep	he does n't just walk and weep
many affluent people place personal success and money above family	many affluent people place personal success and money
pay for performance hangs mostly on boss 's subjective view	pay hangs mostly
mr. sherry declined to comment when asked about the sales	mr. sherry declined to comment when asked
hambros rose 5 to 204 and schroders rose 25 to 12.75	hambros rose 5 and schroders rose 25
in the 300-a-share buyout that totaled about 76.7 million	that totaled about 76.7 million
remember those bulky thick-walled refrigerators of 30 years ago	remember those bulky thick-walled refrigerators
he succeeds john a. boudreau who resigned for personal reasons	he succeeds john a. boudreau who resigned
it has been trying to improve its share of the residential market	it has been trying to improve its share
it is a knock-out battle perhaps to the death	it is a knock-out battle perhaps
the exclusion would apply to assets sold after oct. 1 1989	the exclusion would apply
maybe he thinks they should also sell to the highest bidder	maybe he thinks they should also sell
california 's insurance commissioner does n't hold hearings on acquisition applications	california 's insurance commissioner does n't hold hearings
sometimes like now it 's gray	sometimes it 's gray
the buy-out group had no firm financing for the plan	the buy-out group had no firm financing
people have a different reputation country by country	people have a different reputation country
but that development also had little effect on traders ' sentiment	but that development also had little effect
interest payments on the bonds will be payable semiannually	interest payments will be payable semiannually
a raft of new computer companies also has targeted this server market	a raft also has targeted this server market
the value traded on the exchanges is close to 3 trillion	the value traded is close to 3 trillion
this was too much for james oakes the court 's chief judge	this was too much
but it never did let up on the pressure	but it never did let up
i look at it as a ho-hum matter he says	i look he says
the figures exclude businesses now organized as american express information services co	the figures exclude businesses now organized
but he said a system such as ibm 's should help significantly	but he said a system should help significantly
sales fell 1.5 % to 884 million from 897.2 million	sales fell 1.5 %
citicorp posted a 9 % drop in quarterly profit	citicorp posted a 9 % drop
the u.s. contends that the rules are n't justified on health grounds	the u.s. contends that the rules are n't justified
joanne lipman contributed to this article	joanne lipman contributed
hilton rose 2 7\/8 to 100 for example	hilton rose 2 7\/8
the investors range from elderly widows to affluent professionals	the investors range
part of drexel 's plea was to cut mr. milken loose	part was to cut mr. milken loose
researchers can apply for permission to use the probes for brain studies	researchers can apply
the three units had combined 1988 sales of about 904 million	the three units had combined 1988 sales
mr. ohmae is managing director of mckinsey & co. in japan	mr. ohmae is managing director
among broader nasdaq industry groups the utility index gained 18.11 to 761.38	the utility index gained 18.11
by comparison republicans have held closer to the anti-abortion movement	republicans have held closer
daiwa is one of the world 's largest securities firms	daiwa is one
european investors have further reason for optimism today after the u.s. rebound	european investors have further reason today
designs call for an l-shaped structure with a playground in the center	designs call
sales rose 9 % to 7.54 billion from 6.95 billion	sales rose 9 %
there 's a casino the financial heart of it all	there 's a casino the financial heart
precision castparts corp. portland ore. will begin trading with the symbol pcp	precision castparts corp. portland ore. will begin trading
even at this early stage drugs caused additional concerns	drugs caused additional concerns
the two sides had n't met since oct. 18	the two sides had n't met
they talked of the aftermath	they talked
the percentage change is since year-end	the percentage change is
we 're not rushing into anything	we 're not rushing
the latest wave of marketing is instructive	the latest wave is instructive
gate receipts are only the cowboys ' second largest source of cash	gate receipts are only the cowboys ' second largest source
forty million in the total scheme of things is not that significant	forty million is not that significant
it looks like a holiday	it looks
the stock split four-for-one on oct. 10	the stock split four-for-one
by afternoon the broader market joined the advance in full strength	the broader market joined the advance
freddie mac 9 % securities were at 97 5\/32 down 3\/32	freddie mac 9 % securities were down 3\/32
as of aug. 31 thrifts held 185 billion in mortgage-backed securities	thrifts held 185 billion
revenue rose 7.7 % to 1.28 billion from 1.18 billion	revenue rose 7.7 %
at this point the dow industrials were down 75.41 points and falling	the dow industrials were down 75.41 points and falling
they 're more worried about bread on the table	they 're more worried
the sustainability of u.s. foreign policy is essential he explains	the sustainability is essential he explains
put march 31 1992 at fixed 107 13\/16 to yield 3.43 %	put march 31 1992 to yield 3.43 %
no safety problems with the products are known the fda said	no safety problems are known the fda said
the market during the start-up is estimated at 25,000 subscribers	the market is estimated
in the end politics got in the way	politics got
in over-the-counter trading yesterday benjamin franklin rose 25 cents to 4.25	yesterday benjamin franklin rose 25 cents
other senators want to lower the down payments required on fha-insured loans	other senators want to lower the down payments required
we are n't looking at anything like a doomsday scenario he says	we are n't looking he says
by then dlj hopes to be able to sell less-junky junk bonds	dlj hopes to be able to sell less-junky junk bonds
but most of those stocks fared well	but most fared well
but by that time many big institutions had switched business to london	but many big institutions had switched business
accepted bids were all at 7.962 %	accepted bids were all
mercedes sold 82,348 cars in 1988	mercedes sold 82,348 cars
the contract also provides for advanced billing and network management services	the contract also provides
norfolk southern went up 1 1\/8 to 37 7\/8	norfolk southern went up 1 1\/8
investors apparently did n't like the news from rainbow technologies either	investors apparently did n't like the news either
on the big board crawford & co. atlanta cfd begins trading today	crawford & co. atlanta cfd begins trading today
ortega cited renewed attacks by the u.s.backed rebels	ortega cited renewed attacks
some think investors should sell into rallies	some think investors should sell
some drill-bit prices have risen 5 % in the past month	some drill-bit prices have risen 5 %
total turnover in glaxo was a thin 975,000 shares	total turnover was a thin 975,000 shares
i spent 30 million in the last half-hour	i spent 30 million
chemical securities inc. is acting as agent for the seller	chemical securities inc. is acting
its stock closed at 38 up 1.875 in national over-the-counter trading	its stock closed up 1.875
sales rose to 406 million from 356 million the year earlier	sales rose
most earn high ratings from credit agencies	most earn high ratings
getting out of them however may be a different story now	getting however may be a different story now
they have the most sophisticated computers in the world says mr. llerena	they have the most sophisticated computers says mr. llerena
confectionery products sales also had strong growth in the quarter	confectionery products sales also had strong growth
hugely popular it is far more flexible than straight whole life	hugely popular it is far more flexible
esselte business systems rose 1 to 43 1\/2	esselte business systems rose 1
he turned himself in to authorities in new york earlier this year	he turned himself in earlier this year
genetic defect spotted in 3-day-old embryo	genetic defect spotted
mr. coffee is a professor at columbia law school	mr. coffee is a professor
revenue was 873.9 million up 7.3 % from 814.8 million	revenue was 873.9 million up 7.3 %
she notes that she also stresses professionalism during her weekly visits	she notes that she also stresses professionalism
nesb is also the parent of omnibank	nesb is also the parent
cnn 's viewer habits have been molded by its format	cnn 's viewer habits have been molded
total operating expenses increased 3.5 % to 2.78 billion from 2.69 billion	total operating expenses increased 3.5 %
but out on cobb parkway ted negas sees it differently	but out ted negas sees it differently
the nasdaq 100 rose 7.08 to 445.23	the nasdaq 100 rose 7.08
the dollar rose against the swiss and french francs	the dollar rose
sun 's results were slightly better than expectations	sun 's results were slightly better
the models which cost about 75,000 each will be used in research	the models which cost about 75,000 each will be used
this could be the first of five or six down quarters	this could be the first
the gap between winners and laggards will grow	the gap will grow
sales were 4.66 billion up 1.3 % from 4.6 billion	sales were 4.66 billion up 1.3 %
the single-day record of 288 million shares was set on oct. 21	the single-day record was set
until now it had sat idle	it had sat idle
dealers said it was hit by some profit-taking after gains since mid-week	dealers said it was hit
conservatives expect bush to solidify their majority on a key court	conservatives expect bush to solidify their majority
on a stand-alone basis the network ought to make money he says	the network ought to make money he says
chivas has an image of something you would savor rather than guzzle	chivas has an image
traders said today may be an anxious day for the market	traders said today may be an anxious day
revenue was flat at 2.59 billion	revenue was flat
a resistance government would walk into kabul	a resistance government would walk
this will give paribas and lonrho joint control of societe commerciale	this will give paribas and lonrho joint control
they 're looking for something that 's very safe	they 're looking
the joke here is that the giants lost by de fault	the joke here is that the giants lost
seats are quoted at 430,000 bid and 525,000 asked	seats are quoted
looking ahead to other commodity markets this week	looking ahead
people got rich through takeovers in those days as they do today	people got rich as they do today
for a long time he ignored baseball altogether even the sports pages	he ignored baseball altogether even the sports pages
congressmen raised the issue yesterday at a hearing	congressmen raised the issue yesterday
magazine publishers are facing spiraling costs and a glut of new titles	magazine publishers are facing spiraling costs and a glut
some 4,300 institutions are part of the pension fund	some 4,300 institutions are part
as of late yesterday the ipo was still on	the ipo was still on
investors with a heavy tax load should take out their calculators	investors should take out their calculators
it 's tabloid news from a to z	it 's tabloid news
on the week ual was down nearly 40 %	ual was down nearly 40 %
in a statement young & rubicam called the award unfortunate but bearable	young & rubicam called the award unfortunate but bearable
as a result u.s. trust 's earnings have been hurt	u.s. trust 's earnings have been hurt
this interest in words goes beyond puns and playfulness however	this interest goes however
the name maidenform was coined by a third business partner enid bissett	the name maidenform was coined
with that authority of course goes an unambiguous accountability	goes an unambiguous accountability
that 's the highest estimate for a single collection in auction history	that 's the highest estimate
admittedly the principle in the cases is the same	admittedly the principle is the same
merchant banker morgan grenfell climbed 14 to 406 on renewed takeover speculation	merchant banker morgan grenfell climbed 14
now movieline is located in the same building as vesoft	now movieline is located
jeff rowe contributed to this article	jeff rowe contributed
he is ogling the curtains rippling above the ventilation ducts	he is ogling the curtains rippling
pemex which produces 40 % of government revenue desperately needs new investment	pemex which produces 40 % desperately needs new investment
like just about everything else that remains to be seen	that remains to be seen
mr. sukle says he would n't dream of participating himself	mr. sukle says he would n't dream
some residents defied orders and returned to red buildings to retrieve goods	some residents defied orders and returned to retrieve goods
a u.s.-made imitation under the title almost anything goes flopped fast	a u.s.-made imitation flopped fast
time eluded paramount by acquiring warner communications inc	time eluded paramount
the 1989 act simply extends these guarantees to the private sector	the 1989 act simply extends these guarantees
the u.s. soon found new cause for concern gun-running	the u.s. soon found new cause gun-running
then he jumped into the market	then he jumped
in addition the principles attempt to eliminate the so-called delaney paradox	the principles attempt to eliminate the so-called delaney paradox
for cathay pacific airways the smooth ride may be ending	the smooth ride may be ending
their effort has received a lukewarm response from the justice department	their effort has received a lukewarm response
collectibles should continue to be recognized as capital assets the letter states	collectibles should continue to be recognized the letter states
he apologizes for sounding pushy	he apologizes
no one ever eats in their books and look at them	no one ever eats and look
the envelope arrives in the mail	the envelope arrives
we were out of the box	we were
revenue nearly tripled to 479 million from 160 million	revenue nearly tripled
serial bonds were priced to yield to 6.80 % in 1999	serial bonds were priced to yield to 6.80 %
exxon corp. said it will move its headquarters from manhattan to dallas	exxon corp. said it will move its headquarters
meanwhile general motors and ford motor continue their pursuit of the company	meanwhile general motors and ford motor continue their pursuit
men would crawl in the sand looking for shiny stones	men would crawl looking
corporations need liquidity in the form of borrowed funds	corporations need liquidity
i think a lot of people got scared and stayed home	i think a lot got scared and stayed home
he predicted the debt ratio will improve further in coming quarters	he predicted the debt ratio will improve further
bolar pharmaceutical co. posted the largest volume increase 552,302 shares to 2,157,656	bolar pharmaceutical co. posted the largest volume increase 552,302 shares
this is an index fund with a bet	this is an index fund
fiat said it 's only interested in technical cooperation with saab	fiat said it 's only interested
prices were mixed in zurich and lower in stockholm	prices were mixed and lower
it will continue to be sold in the european market	it will continue to be sold
sales rose 8.2 % to 848.7 million from 784.5 million	sales rose 8.2 %
the current backlog of orders is strong throughout the corporation he said	the current backlog is strong he said
liza said hello to me	liza said hello
venezuela has also earmarked 200 million in new money for light-crude exploration	venezuela has also earmarked 200 million
everybody 's finger is one inch closer to the button	everybody 's finger is one inch closer
the gene thus can prevent a plant from fertilizing itself	the gene thus can prevent a plant
in los angeles more small businesses ponder adopting a child-care policy	more small businesses ponder adopting a child-care policy
the financial times 100-share index finished at 2161.9 up 12.6 points	the financial times 100-share index finished up 12.6 points
the number of authorized common shares will remain at 100 million	the number will remain
that 's 115 % more than in 1981	that 's 115 % more
this is no longer true because of campeau 's massive debt load	this is no longer true
merrill lynch capital markets inc. is the sole underwriter for the offering	merrill lynch capital markets inc. is the sole underwriter
k mart officials and mr. pilevsky would n't comment on the sale	k mart officials and mr. pilevsky would n't comment
if i need to ask for money up front later i will	if i need to ask later i will
for the government it has become a highly volatile political issue	it has become a highly volatile political issue
your story is an insult to the citizens of the mississippi delta	your story is an insult
erc corp. rose 7\/8 to 12	erc corp. rose 7\/8
billing is included in a caller 's regular phone bill	billing is included
the business closed when the owner was murdered by robbers	the business closed when the owner was murdered
poverty is only two blocks from president bush 's residence	poverty is
sterling was quoted at 1.5820 up from 1.5795 late friday	sterling was quoted
sony was down 130 to 8,590	sony was down 130
still radio shack is aware that some of its products are controversial	still radio shack is aware that some are controversial
the 1988 results were restated for accounting-rules changes	the 1988 results were restated
at some point it will become non-economical for one company	it will become non-economical
the deal would require approval by a majority of jaguar shareholders	the deal would require approval
rates for the wall street journal reports will remain unchanged	rates will remain unchanged
i have plenty more at home	i have plenty more
ibm and mca formed discovision in 1979 to make laser-read optical products	ibm and mca formed discovision to make laser-read optical products
in los angeles it 's important to catch people just after work	it 's important to catch people
there 's unbelievable pressure on economists to forecast these numbers he says	there 's unbelievable pressure to forecast these numbers he says
we suspected there was downtime built into our process	we suspected there was downtime built
the highway system is screwed up by the earthquake mr. engelken said	the highway system is screwed up mr. engelken said
volume has been appalling said a dealer at a british brokerage concern	volume has been appalling said a dealer
sales increased 11.9 % to 279.39 billion yen from 249.68 billion yen	sales increased 11.9 %
no age group is more sensitive than younger voters like ms. ehman	no age group is more sensitive
some companies including heinz even pay part of the fee	some companies even pay part
and his outlook improved after successful cataract surgery in august	and his outlook improved
you can drive piles on it and build on it	you can drive piles and build
given the weakness of the junk-bond market can he finance a buy-out	can he finance a buy-out
ira rules have been changed over the years	ira rules have been changed
the government had fallen 300 million behind in interest payments	the government had fallen 300 million behind
accepted theories of asset pricing offer a perfectly legitimate explanation	accepted theories offer a perfectly legitimate explanation
with little competition the computer industry here is inefficient	the computer industry here is inefficient
john e. yang contributed to this article	john e. yang contributed
mason serves commercial and government customers including the national institutes of health	mason serves commercial and government customers
fund selling also picked up at that point	fund selling also picked up
what 's happening here is n't justified by the fundamentals	what 's happening here is n't justified
serial certificates yield to 7.10 % in 2004	serial certificates yield to 7.10 %
star states plunged 3 1\/4 to 8 3\/4 on 207,000 shares	star states plunged 3 1\/4
for the giuliani forces it 's a conundrum	it 's a conundrum
more banks are being hurt by arizona 's worsening real-estate slump	more banks are being hurt
customized baskets of fewer stocks will also be available	customized baskets will also be available
a year later she moved to the commercial property claims division	a year later she moved
about 190 million were offered through shearson lehman hutton inc	about 190 million were offered
asset-management fee revenue grew 12 % to 151 million	asset-management fee revenue grew 12 %
it plans to sell 1,700 units in 1989	it plans to sell 1,700 units
most economists expect the slowing u.s. economy to curb demand for imports	most economists expect the slowing u.s. economy to curb demand
whitbread bought the beefeater distillery two years ago for 174.5 million	whitbread bought the beefeater distillery two years ago
it expects any impact on its business to be slight	it expects any impact to be slight
clearly people like mrs. lombardi are giving marketers fits	clearly people are giving marketers fits
he cut the dropout rate by 5.5 %	he cut the dropout rate
mr. schwarz says the competition broadens the base of opportunity for us	mr. schwarz says the competition broadens the base
this is no time to be playing in the street	this is no time to be playing
the company can go about its business	the company can go
ncnb continued its foray into the florida and texas markets	ncnb continued its foray
showing up in court without being there	showing up
some conservatives will accuse the president of promising congress too much	some conservatives will accuse the president
otherwise actual profit is compared with the 300-day estimate	otherwise actual profit is compared
sales rose 7.4 % to 580 million from 540 million	sales rose 7.4 %
it was bedlam on the upside said one big board specialist	it was bedlam said one big board specialist
bankamerica 's profit jumped 34 % in the third quarter	bankamerica 's profit jumped 34 %
characters complain ceaselessly about food queues prices and corruption	characters complain ceaselessly
the conversion price for the debentures is 41.725 a share	the conversion price is 41.725 a share
the two sides now are accusing each other of lying	the two sides now are accusing each other
mr. pilson 's rivals at abc and nbc grimaced at the price	mr. pilson 's rivals grimaced
it was a jarring day for investors in genetics institute	it was a jarring day
in september 1988 that level was 9.5 %	that level was 9.5 %
but it may have a good listener in washington	but it may have a good listener
not all funds have raised cash levels of course	not all funds have raised cash levels
china-bound freight streams through the territory 's port	china-bound freight streams
the lawyers are now in charge of our national security	the lawyers are now
judges will write the real bill as suits roll through the courts	judges will write the real bill as suits roll
officials at goldman sachs and salomon brothers were unavailable for comment	officials were unavailable
in indianapolis lilly declined comment	lilly declined comment
that 's the path of reasoning leading to growth stocks	that 's the path leading
elsewhere share prices closed higher in amsterdam brussels milan and paris	elsewhere share prices closed higher
such caution was evident after the recent friday-the-13th stock market plunge	such caution was evident
at this point the truce between feminism and sensationalism gets mighty uneasy	the truce gets mighty uneasy
unemployment in september dropped to 1,695,000 the lowest level since 1980	unemployment dropped
you have to beat everyone around the world says mr. dennis	you have to beat everyone says mr. dennis
mr. sheinberg remains as executive vice president	mr. sheinberg remains
a pair of black skimmers zig-zag past close to the surface	a pair zig-zag past close
chicagoans have just elected 540 neophyte school boards one for each school	chicagoans have just elected 540 neophyte school boards one
capital travels to europe as 1992 unification nears	capital travels as 1992 unification nears
some companies are cutting costs and hoping for the best	some companies are cutting costs and hoping
details of the escrow agreement have n't been completed the companies said	details have n't been completed the companies said
new entitlements tend to grow creating a rationale for new taxes	new entitlements tend to grow creating a rationale
this will raise the energy level of the show	this will raise the energy level
we have some level of financial interest in the collection	we have some level
he became angry in return	he became angry
about 550 million of long-term debt is affected according to moody 's	about 550 million is affected
among them were the alq-135 electronic countermeasures system for the f-15 fighter	were the alq-135 electronic countermeasures system
over a cup of coffee mr. stone told his story	mr. stone told his story
olivetti reportedly began shipping these tools in 1984	olivetti reportedly began shipping these tools
at his first chicago press conference he berated the reporters	he berated the reporters
his 1988 salary was 575,000 with a 575,000 bonus	his 1988 salary was 575,000
and unlike ibm 's water-cooled mainframes it does n't need any plumbing	and it does n't need any plumbing
the advance felt more like a technical bounce he said	the advance felt he said
the contract signing represented a major step in the long-planned petrochemical project	the contract signing represented a major step
sales increased 36 % to 683 million from 502 million	sales increased 36 %
one man wrapped several diamonds in the knot of his tie	one man wrapped several diamonds
that tariff is too stiff for some financial district wage earners	that tariff is too stiff
revenue gained 45 % to 210.2 million from 145.2 million	revenue gained 45 %
the value of the transaction was n't disclosed	the value was n't disclosed
the attention span of the public is short he said	the attention span is short he said
cd yields are generally expected to fall further in coming weeks	cd yields are generally expected to fall further
the proposal values the company 's real estate operation at 2 billion	the proposal values the company 's real estate operation
again no such statement appears on the tapes	again no such statement appears
yesterday the stock market 's influence at first created nervousness	yesterday the stock market 's influence created nervousness
strikes and mismanagement were cited and premier ryzhkov warned of tough measures	strikes and mismanagement were cited and premier ryzhkov warned
enforcement of restricted-entry rules was sporadic residents said	enforcement was sporadic residents said
sales increased 10 % to 2.65 billion from 2.41 billion	sales increased 10 %
warned he was to be jailed again he fled to the countryside	warned he was to be jailed again he fled
but east germany is merely the land of truly existing socialism	but east germany is merely the land
i ca n't really see it dropping far below 1.80 marks	i ca n't really see it dropping
mr. shiflett is an editorial writer for the rocky mountain news	mr. shiflett is an editorial writer
study halls complete with reference materials will be available	study halls complete will be available
the committee formed in 1967 now has 60 chapters around the world	the committee formed now has 60 chapters
the company is a mexico mo. maker of refractory products	the company is a mexico mo. maker
per-share net rose to 47.46 yen from 39.31 yen	per-share net rose
the company 's sales flattened during 1989 's first half	the company 's sales flattened
daiwa house gained 50 to 2,660	daiwa house gained 50
transcanada is 49.1 % owned by montreal-based holding company bce inc	transcanada is 49.1 % owned
ncnb corp. raised 1 billion in new capital during the third quarter	ncnb corp. raised 1 billion
if convicted they could be sentenced to death	if convicted they could be sentenced
but mr. rose is still looking seriously at the 9000	but mr. rose is still looking seriously
no reason for the request was given	no reason was given
asked about that the other day he replied anti-semitic	asked the other day he replied anti-semitic
the december contract fell 3.85 cents a pound to 1.1960	the december contract fell 3.85 cents a pound
a few weeks ago new york sold 750 million of tax-exempts	a few weeks ago new york sold 750 million
otherwise actual profit is compared with the 300-day estimate	otherwise actual profit is compared
lawyers for the company and executives could n't be reached for comment	lawyers could n't be reached
we will only deal with clients on the phone he says	we will only deal he says
foreign traders say the company is strapped for cash	foreign traders say the company is strapped
but not a single piece of paper was sold	but not a single piece was sold
the young farmer makes money on the few hogs he sells here	the young farmer makes money
the offering series 1989-84 is backed by fannie mae 9 % securities	the offering series 1989-84 is backed
but the apple industry is ripe for change	but the apple industry is ripe
in the end i think david will be judged for being david	i think david will be judged
i 'm a math major but i want to know about psychobiology	i 'm a math major but i want to know
away from the general obligation sector activity was modest	away activity was modest
at painewebber inc. they are investment executives	they are investment executives
jaguar shares jumped 23 before easing to close at 654 up 6	jaguar shares jumped 23
would n't the japanese like a piece of it	would n't the japanese like a piece
however pressure on kidder 's parent ge could change kidder 's policy	however pressure could change kidder 's policy
inflation may be stable at the moment running at about 4.5 %	inflation may be stable running
coach them in handling complaints so that they can resolve problems immediately	coach them so that they can resolve problems immediately
revenue rose to 4.45 billion from 4.15 billion	revenue rose
the measure also includes spending cuts and increases in federal fees	the measure also includes spending cuts and increases
the red granite mausoleum draws thousands of visitors daily	the red granite mausoleum draws thousands daily
the party is fed up with sackings of good people	the party is fed up
separately century bank phoenix ariz. was closed by arizona banking officials	separately century bank phoenix ariz. was closed
one apparent side effect is a minor increase in a brain hormone	one apparent side effect is a minor increase
both residents ' organizations admit to receiving some funding from abroad	both residents ' organizations admit
the law sets a deficit target of 100 billion for fiscal 1990	the law sets a deficit target
amgen rose 1 1\/2 to 50 3\/4 in heavy trading	amgen rose 1 1\/2
the stock began trading this summer at 14 apiece	the stock began trading this summer
the notes can be redeemed starting in july 1991	the notes can be redeemed
operating profit of 37.2 million was unchanged	operating profit was unchanged
the new line is aimed directly at international business machines corp	the new line is aimed directly
ual 's stock fell 6.25 to 191.75	ual 's stock fell 6.25
non-interest expenses grew 16 % to 496 million	non-interest expenses grew 16 %
di provenza was n't much of an advertisement for sunny southern france	di provenza was n't much
delayed financings also would affect the operations of many companies	delayed financings also would affect the operations
indeed over-the-counter stocks led by technology issues outleaped the industrial average	indeed over-the-counter stocks led outleaped the industrial average
that must start with cutting the federal budget deficit	that must start
some bourbon makers advertise abroad as they do at home	some bourbon makers advertise abroad as they do
the subscribers are in 52 different communities in georgia alabama and mississippi	the subscribers are
in a downward market bonds act better he said	bonds act better he said
to be sure the stock still has a lot of fans	to be sure the stock still has a lot
hundreds of smaller creditors could get nothing according to attorneys involved	hundreds could get nothing
sometimes traders lose sight of that he says	sometimes traders lose sight he says
two workers died and six remain in the hospital	two workers died and six remain
there were no major eurobond or foreign bond offerings in europe friday	there were no major eurobond or foreign bond offerings friday
but analysts estimate their trading profit at 30 million	but analysts estimate their trading profit
erbamont advanced 1 1\/8 to 36 1\/2 on 1.9 million shares	erbamont advanced 1 1\/8
the diplomat adds that mr. krenz has several things going for him	the diplomat adds that mr. krenz has several things going
we want it to be a '90s kind of image	we want it to be a '90s kind
she was in her most radiant expressive voice	she was
tokyu executives were n't available for comment early thursday morning in tokyo	tokyu executives were n't available early thursday morning
if the playoffs end in four-game sweeps losses could soar	if the playoffs end losses could soar
with inflation surging the pound began falling against the mark	the pound began falling
the secretary is the world 's biggest borrower of money	the secretary is the world 's biggest borrower
this building shook like hell and it kept getting stronger	this building shook and it kept getting stronger
a 14 % inflation rate dropped below 5 %	a 14 % inflation rate dropped
quebecor will own 57.5 % of the new subsidiary	quebecor will own 57.5 %
delivery is to begin in early 1991	delivery is to begin
it reduces the baseline by 169 billion	it reduces the baseline
bonuses would be paid based on playing time and performance	bonuses would be paid based
he intends to add to the litigation staff	he intends to add
the year was misstated in friday 's editions	the year was misstated
in a letter to the bpca kelly\/varnell called this arbitrary and amateurish	kelly\/varnell called this arbitrary and amateurish
a temporary prohibition was imposed in march 1988	a temporary prohibition was imposed
it is the stuff of dreams but also of traumas	it is the stuff
the committee gave the government until nov. 15 to revise the proposal	the committee gave the government to revise the proposal
buy stocks on weakness for their long-term fundamentals he says	buy stocks he says
british airways said it has n't received a proposal from jal	british airways said it has n't received a proposal
the stock gained 2.75 thursday to close at a then-52 week high	the stock gained 2.75 thursday to close
in the latest quarter at least profit is expected to fall sharply	at least profit is expected to fall sharply
individual and japanese participation in the auction was disappointing according to dealers	individual and japanese participation was disappointing
in fact some economists contend that the latest easing started last week	some economists contend that the latest easing started last week
elsewhere in europe share prices closed higher in stockholm brussels and milan	elsewhere share prices closed higher
dell computer dropped 7\/8 to 6	dell computer dropped 7\/8
here 's a waltana he exclaims picking one off a tree	here 's a waltana he exclaims picking one
it also inevitably leaves a residue of shareholder lawsuits	it also inevitably leaves a residue
tomorrow the treasury will sell 10 billion of two-year notes	tomorrow the treasury will sell 10 billion
get caught and you 're dead in the water says mr. thal	get caught and you 're dead says mr. thal
the irs assessed the clinic 350,000 in back payroll taxes	the irs assessed the clinic 350,000
prince henri is the crown prince and hereditary grand duke of luxembourg	prince henri is the crown prince and hereditary grand duke
associate member seats currently are quoted at 225,000 bid 256,000 asked	associate member seats currently are quoted
maybe they were hidden by all the people	maybe they were hidden
at first glance gold and utilities seem strange bedfellows	gold and utilities seem strange bedfellows
but the ec is strongly opposed to converting agricultural supports into tariffs	but the ec is strongly opposed
sales were 348.2 million compared with 307.2 a year earlier	sales were 348.2 million
a large number of those leaving are managers and professionals	a large number are managers and professionals
chevron added 1 to 65	chevron added 1
on some days the nucor plant does n't produce anything	the nucor plant does n't produce anything
nevertheless the device has been successful in other ways	nevertheless the device has been successful
the highest-yielding funds are still above 9 %	the highest-yielding funds are still
but volume rose only to 162 million shares from 143 million friday	but volume rose only
the board has 13 members elected by holders and five presidential appointees	the board has 13 members elected and five presidential appointees
whether she can meet that ambitious goal is still far from certain	whether she can meet that ambitious goal is still
we 're not rushing into anything	we 're not rushing
the company earned 6.6 million in the year-earlier quarter	the company earned 6.6 million
share prices fell in milan amsterdam zurich madrid and stockholm	share prices fell
we suspect voters are fed up with the finagling	we suspect voters are fed up
terms on both deals were n't disclosed	terms were n't disclosed
inspired by imports mr. rosen now makes fur muffs hats and flings	inspired mr. rosen now makes fur muffs hats and flings
we 've taken more than our fair share	we 've taken more
a number of developments were negatively interpreted by traders	a number were negatively interpreted
the big one is still due mr. johnson predicted in an interview	the big one is still due mr. johnson predicted
in recent days mr. krenz has sought to project a kinder image	mr. krenz has sought to project a kinder image
the successors would be nominated by the independent directors	the successors would be nominated
so far it appears cautious about taking the big step	so far it appears cautious
known as easy eggs the product has disappointed investors	known the product has disappointed investors
that could shove a weak economy into recession	that could shove a weak economy
the barometer of the biggest nonfinancial stocks settled at 448.49 off 1.40	the barometer settled off 1.40
ms. mcglade of painewebber raised a more fundamental question about the deal	ms. mcglade raised a more fundamental question
mr. sung formerly worked at general electric in research on synthetic diamonds	mr. sung formerly worked
edisto currently is the general partner of nrm	edisto currently is the general partner
travel sales rose 11 % led by gains in the u.s.	travel sales rose 11 % led
revenue rose 5 % to 282 million from 268.3 million	revenue rose 5 %
at the time the plan was announced there were 135 lawyers	there were 135 lawyers
the yield on the issue stood at 7.88 %	the yield stood
students should move up the educational ladder as their academic potential allows	students should move as their academic potential allows
the series typically is among the highest-rated sports events on television	the series typically is
call it the uninformed trudging after the incomprehensible	call it the uninformed trudging
the issue here may be the soundness of the guarantee	the issue here may be the soundness
you ca n't say the same with black and white	you ca n't say the same
here are details of yesterday 's three-month and six-month bill auction	here are details
mr. orr could n't be reached for comment yesterday	mr. orr could n't be reached yesterday
some nights he slept under his desk	some nights he slept
for the fourth quarter bristol-myers squibb will report one set of earnings	bristol-myers squibb will report one set
cuban military personnel also have been active in afghanistan since 1979	cuban military personnel also have been active
its buglike carol minicar is designed with softness gentleness and warmheartedness	its buglike carol minicar is designed
it 's all i think about or talk about	it 's all i think or talk
trading also was heavy in the over-the-counter market	trading also was heavy
for starters some people call ed and lorraine warren	some people call ed and lorraine warren
it 's an inherited human disorder that 's been duplicated in mice	it 's an inherited human disorder that 's been duplicated
on second thought make that just mom	make that just mom
i 'm not going to address questions of safety	i 'm not going to address questions
and the japanese are likely to keep close on conner 's heels	and the japanese are likely to keep close
norman j. harrison chairman will succeed him as chief executive	norman j. harrison chairman will succeed him
the average three-month issue rose to 8.05 % from 7.77 %	the average three-month issue rose
in 1985 china had a record deficit of 11.4 billion	china had a record deficit
some analysts are cynical about the new corporate interest in health-care overhaul	some analysts are cynical
for many money managers the past four months have been humiliating	the past four months have been humiliating
a spokesman for the comex could n't be reached to comment	a spokesman could n't be reached to comment
georgia-pacific closed down 2.50 at 50.875 in big board trading	georgia-pacific closed down 2.50
neither side showed any sign of retreating	neither side showed any sign
revenue soared to 101.7 million from 39.5 million	revenue soared
telerate provides information about financial markets through an electronic network	telerate provides information
more troubling for mr. dinkins is his record in personal accounting	more troubling is his record
allied-lyons while powerful in whiskey does n't own any major white-spirit brands	allied-lyons while powerful does n't own any major white-spirit brands
declining issues on the big board outstripped gainers 1,141 to 406	declining issues outstripped gainers 1,141
imelda marcos asks for dismissal says she was kidnapped	imelda marcos asks says she was kidnapped
a totals include only vehicle sales reported in the period	a totals include only vehicle sales reported
that is a property right that belongs to the performer	that is a property right that belongs
finding him became an obsession for mr. stoll	finding him became an obsession
his approach to the recantation is direct but low-key	his approach is direct but low-key
analysts say additional investors transferred their assets into money funds this month	analysts say additional investors transferred their assets this month
we just do n't have that kind of income stream	we just do n't have that kind
made of sand it receives around-the-clock maintainence against the battering waves	made it receives around-the-clock maintainence
chevrolet already has cash incentives on the 1989 models of these vehicles	chevrolet already has cash incentives
their yields are higher than those of u.s. treasury issues	their yields are higher
but service on the line is expected to resume by noon today	but service is expected to resume
canada is the world 's largest producer of market pulp	canada is the world 's largest producer
sales rose 4.8 % to 1.20 billion from 1.14 billion	sales rose 4.8 %
this put mrs. thatcher in a bind	this put mrs. thatcher
sterling was quoted at 1.5765 sharply down from 1.6145 late wednesday	sterling was quoted sharply down
in other words they treat you like a piece of meat	they treat you
mid-sized companies were most affected by talk of layoffs or plant closings	mid-sized companies were most affected
a policeman shakes his head in amazement as he steers them away	a policeman shakes his head as he steers them away
there is nothing wrong with the company says coniston principal paul tierney	there is nothing wrong says coniston principal paul tierney
as of sept. 30 halsey had 5.3 million common shares outstanding	halsey had 5.3 million common shares outstanding
the issue has been simmering for years	the issue has been simmering
revenue rose 2 % to 1.58 billion from 1.54 billion	revenue rose 2 %
proceeds from the offering are about 160.4 million	proceeds are about 160.4 million
the result is a 45 billion market according to securities data co	the result is a 45 billion market
brawls between union factions still erupt at pemex installations	brawls still erupt
local pollution problems require cheap energy and capital for their solution	local pollution problems require cheap energy and capital
blue chips he says are now being referred to as poker chips	blue chips he says are now being referred
the post had been vacant for more than a year	the post had been vacant
japan is a major target for the soviets	japan is a major target
company expects to be fully operational by next week	company expects to be fully operational
polysilicon is used in making integrated circuits	polysilicon is used
some frantically dumped belongings into pillowcases others threw goods out windows	some frantically dumped belongings others threw goods
in tokyo trading is halted during lunchtime	trading is halted
the company 's excalibur will also appeal to families of course	the company 's excalibur will also appeal
after that the layout had been easy	the layout had been easy
some in big oil are easing the grip on their wallets	some are easing the grip
french state-owned rhone-poulenc s.a. holds 51 % of merieux	french state-owned rhone-poulenc s.a. holds 51 %
mr. daremblum is a lawyer and a columnist for la nacion newspaper	mr. daremblum is a lawyer and a columnist
the senate did n't vote on six lesser charges	the senate did n't vote
never once did she gasp for air or mop her brow	never once did she gasp or mop her brow
mrs. allen is a senior editor of insight magazine	mrs. allen is a senior editor
the wholesale price index stood at 89.6 1985 equals 100	the wholesale price index stood 1985 equals 100
serial bonds are priced to yield to 7 % in 1999	serial bonds are priced to yield to 7 %
he still has 1,143 shares according to sec files	he still has 1,143 shares
gerald f. seib contributed to this article	gerald f. seib contributed
dpc holds about 7.8 % of dataproducts ' shares	dpc holds about 7.8 %
young & rubicam has pleaded innocent to the charges	young & rubicam has pleaded innocent
bloomingdale 's does an estimated 1.2 billion in annual sales	bloomingdale 's does an estimated 1.2 billion
when mr. trump sued bally he sued only on behalf of himself	when mr. trump sued bally he sued
ex-im bank officials said this review process currently is under way	ex-im bank officials said this review process currently is
it closed yesterday at 34 3\/4	it closed yesterday
in 1987 he became deputy chief of the civil division	he became deputy chief
the index slid 647.33 points or 1.8 % on monday	the index slid 647.33 points or 1.8 %
each share point is worth about 60 million in sales	each share point is worth about 60 million
mr. ayers is editor and publisher of the anniston ala. star	mr. ayers is editor and publisher
it sees sales rising 45 % to 26,000 units next year	it sees sales rising 45 %
the bank made a 4.5 million provision in the 1988 quarter	the bank made a 4.5 million provision
computer makers were scrambling to help customers recover from the disaster	computer makers were scrambling to help customers recover
the offer has an indicated value of 268 million	the offer has an indicated value
the books 1,500 entries include stepping on cracks and knocking on wood	the books 1,500 entries include stepping and knocking
i got to get back to school and straighten out my english	i got to get back and straighten out my english
atlanta mr. savageau sniffs has unrealistic pretensions to world-class status	atlanta mr. savageau sniffs has unrealistic pretensions
the switch to the london market during such turbulent times is significant	the switch is significant
you are a dinosaur a hangover in a 10 suit	you are a dinosaur a hangover
it 's like an oasis in this room ms. foster purrs	it 's ms. foster purrs
aoki gained 60 yen to 1,480 yen 10.40	aoki gained 60 yen
ms. garman could n't be reached for comment	ms. garman could n't be reached
the measure is expected to move through this congress	the measure is expected to move
the board expands to seven members	the board expands
the apparel maker would n't disclose terms of the agreement	the apparel maker would n't disclose terms
mr. breeden offered strong support for two other provisions in the bill	mr. breeden offered strong support
the association said domestic demand grew 8.8 % in september	the association said domestic demand grew 8.8 %
i played very transparently with the tip of the bow	i played very transparently
office market weakens in overbuilt northeast	office market weakens
the ira portion of the packwood-roth plan is irresponsible	the ira portion is irresponsible
now after beating them mr. achenbaum is joining them	now mr. achenbaum is joining them
we were coming down straight into their canal	we were coming down
many other factors played a part in yesterday 's comeback	many other factors played a part
columbia savings is a major holder of so-called junk bonds	columbia savings is a major holder
in other words it was a better-than-average manhattan commute	it was a better-than-average manhattan commute
mr. putka covers education from the wall street journal 's boston bureau	mr. putka covers education
the estimate includes the results of new stores	the estimate includes the results
never in my life have i been so frightened	never have i been so frightened
i 've got 70 kinds of apples	i 've got 70 kinds
third-quarter profits fell at several companies	third-quarter profits fell
production is slated to begin in april	production is slated to begin
how could cbs get pushed into outbidding itself	how could cbs get pushed
there is no charge for research only for time on the phone	there is no charge
the average daily share turnover for october is almost 148 million shares	the average daily share turnover is almost 148 million shares
brokerage hiring languishes amid market turmoil	brokerage hiring languishes
so they were surprised and very disappointed by prepayment	so they were surprised and very disappointed
each has an equal vote at the monthly meetings	each has an equal vote
however operating profit fell 35 % to 16.4 million	however operating profit fell 35 %
maybe it was their peculiar sense of history	maybe it was their peculiar sense
also profit rose 19 % in the third quarter	also profit rose 19 %
and then there 's the case of the missing gold watch	and then there 's the case
the merger is subject to regulatory clearance and a definitive agreement	the merger is subject
we believe that the vast majority of imported material is safe	we believe that the vast majority is safe
rigid ideological restrictions on property ownership should be abandoned	rigid ideological restrictions should be abandoned
that in turn could substantially reduce the value of the television assets	that could substantially reduce the value
today the treasury will sell 10 billion of new two-year notes	today the treasury will sell 10 billion
the babelists of the united nations are experts at obfuscation	the babelists are experts
motorola another major semiconductor producer dropped 1 1\/8 to 57 1\/2	motorola another major semiconductor producer dropped 1 1\/8
and of course there 's the unsteady labor situation	and there 's the unsteady labor situation
a spokesman said the company had sales of 400 million in 1988	a spokesman said the company had sales
mr. peake is chairman of his own consulting company in englewood n.j	mr. peake is chairman
i show it to my friends and they all say wow	i show it and they all say wow
compare the bush request to what the senators gave themselves	compare the bush request
indeed his caution has become legendary within the government	indeed his caution has become legendary
the value of the company has changed	the value has changed
nevertheless he deems the deal plain smart for its huge promotional value	nevertheless he deems the deal plain smart
details of credit enhancements vary widely from issue to issue	details vary widely
mr. bush returned to washington saturday night	mr. bush returned saturday night
the complexities of the insurance problem make the outcome difficult to predict	the complexities make the outcome difficult to predict
blue arrow added 1\/2 to 17 1\/4	blue arrow added 1\/2
but you know about campaign promises	but you know
the bikes are unwelcome on trails in national parks	the bikes are unwelcome
texaco has purchased an oil-producing company in texas for 476.5 million	texaco has purchased an oil-producing company
the companies said the acquisition is subject to a definitive agreement	the companies said the acquisition is subject
having been through several tornadoes and hurricanes i have a different perspective	having been i have a different perspective
it operates various types of addiction-treatment facilities	it operates various types
cable & wireless plc of britain won the other license	cable & wireless plc won the other license
total return is price changes plus interest income	total return is price changes
you can take them with you	you can take them
the company plans to expand plant capacity 50 % by 1991	the company plans to expand plant capacity 50 %
the magazine called in mr. hyman as a consultant	the magazine called in mr. hyman
the oldest designer got to work on the dashboard she recalls	the oldest designer got to work she recalls
it said 10 million would go to the university of toronto	it said 10 million would go
cable & wireless fell 20 to 478	cable & wireless fell 20
she retains her duties of human-resources director	she retains her duties
b.a.t said it purchased 2.5 million shares at 785	b.a.t said it purchased 2.5 million shares
crested butte population 1,200 is a bastion of the sport	crested butte population 1,200 is a bastion
finnair would receive sas shares valued at the same amount officials said	finnair would receive sas shares valued officials said
