she thought i was n't getting my practicing done	she will think i will not be getting my practicing done
but this is not enough	but this will be not enough
sea containers which unveiled a proposed restructuring advanced 1 to 62	sea containers which will unveil a proposed restructuring will advance 1 to 62
cnn 's viewer habits have been molded by its format	cnn 's viewer habits will have been molded by its format
their reaction was to do nothing and ride it out	their reaction will be to will nothing and ride it out
they do n't have the votes to get it passed	they will not have the votes to get it passed
i 'm probably not going to vote for any capital-gains proposal	i will be probably not going to vote for any capital-gains proposal
collagen dropped 2 5\/8 to 15 5\/8 on 428,000 shares	collagen will drop 2 5\/8 to 15 5\/8 on 428,000 shares
goldman sachs 's mr. einhorn for one subscribes to that scenario	goldman sachs 's mr. einhorn for one will subscribe to that scenario
some economists found the mixture ominous	some economists will find the mixture ominous
and the number of rigs active in the u.s. is inching up	and the number of rigs active in the u.s. will be inching up
i was never a rebel he said in an earlier interview	i will be never a rebel he will say in an earlier interview
but burns confesses in an interview that 's not my handwriting	but burns will confess in an interview that will not be my handwriting
the u.s. contends that the rules are n't justified on health grounds	the u.s. will contend that the rules will not be justified on health grounds
but most cases of non-violent civil disobedience are not nearly so benign	but most cases of non-violent civil disobedience will be not nearly so benign
the dollar is still highly volatile	the dollar will be still highly volatile
addison is no stranger to cans of worms either	addison will be no stranger to cans of worms either
but he adds everybody and his sister have opened up m&a shops	but he will add everybody and his sister will have opened up m&a shops
the afl-cio also embraces treatment guidelines	the afl-cio also will embrace treatment guidelines
the stock was trading at 69 just two weeks ago	the stock will be trading at 69 just two weeks ago
farm income is 15 % below the average	farm income will be 15 % below the average
all that now has changed	all that now will have changed
sun co. also reported higher earnings	sun co. also will report higher earnings
american medical jumped 1 7\/8 to 23 5\/8	american medical will jump 1 7\/8 to 23 5\/8
it made our new year says mr. quinlan	it will make our new year will say mr. quinlan
sometimes as with batman the pair really do make the film	sometimes as with batman the pair really will make the film
most other states have enacted similar bans	most other states will have enacted similar bans
messrs. roberts and stein could n't be reached for comment	messrs. roberts and stein can n't be reached for comment
the program expires april 27	the program will expire april 27
the best odds are with your core franchise	the best odds will be with your core franchise
you 're probably right and you are n't alone	you will be probably right and you will not be alone
today morgenzon is a town of 800 whites and two paved roads	today morgenzon will be a town of 800 whites and two paved roads
and the show 's creativity makes up for any technological deficiencies	and the show 's creativity will make up for any technological deficiencies
bonds due 2003 2004 and 2015 are n't being formally reoffered	bonds due 2003 2004 and 2015 will not be being formally reoffered
investment-grade corporate municipal and mortgage-backed securities also fell	investment-grade corporate municipal and mortgage-backed securities also will fall
maybe it was just a vulnerable time says mr. cortese	maybe it will be just a vulnerable time will say mr. cortese
giveaways just give people the wrong image said mr. heinemann	giveaways will just give people the wrong image will say mr. heinemann
marginal operations and assets have been sold	marginal operations and assets will have been sold
but the chain is quickly realizing the pitfalls of such endorsements	but the chain will be quickly realizing the pitfalls of such endorsements
the laws take effect next month	the laws will take effect next month
no wonder the competition 's green with envy the announcer says	no wonder the competition will be green with envy the announcer will say
robert g. hodson 65 retired as chairman but will remain a consultant	robert g. hodson 65 will retire as chairman but will remain a consultant
par said it is cooperating in the investigation	par will say it will be cooperating in the investigation
the increase was spread fairly evenly among all three types of funds	the increase will be spread fairly evenly among all three types of funds
the results are almost identical to shapiro 's september 1988 numbers	the results will be almost identical to shapiro 's september 1988 numbers
the largest suburban propane was already owned by quantum	the largest suburban propane will be already owned by quantum
other losing issues included showa shell which fell 40 to 1,520	other losing issues will include showa shell which will fall 40 to 1,520
i call her agent david dominici	i will call her agent david dominici
they were the signature of his adversary panamanian leader manuel antonio noriega	they will be the signature of his adversary panamanian leader manuel antonio noriega
mr. carter is a political commentator who heads a television production firm	mr. carter will be a political commentator who will head a television production firm
some of the recent selling could actually be considered a positive sign	some of the recent selling can actually be considered a positive sign
yesterday 's october gain of 4 was miniscule compared with that	yesterday 's october gain of 4 will be miniscule compared with that
telerate provides information about financial markets through an electronic network	telerate will provide information about financial markets through an electronic network
investors and analysts applauded the news	investors and analysts will applaud the news
total snack-food profit rose 30 %	total snack-food profit will rise 30 %
opinion is mixed over its three-month prospects	opinion will be mixed over its three-month prospects
i trusted in his lordship 's wisdom	i will trust in his lordship 's wisdom
how was the west won	how was the west will won
this conclusion he said restored the credibility of tokyo stocks	this conclusion he will say will restore the credibility of tokyo stocks
a lot of car alarms went off	a lot of car alarms will go off
